id,state_ut_name,year,jail_type,male_convicts,female_convicts,total_convicts,male_under_trial,female_under_trial,total_under_trial,male_detenues,female_detenues,total_detenues,male_others,female_others,total_others,total_male,total_female,grand_total
0,Andhra Pradesh,2001,Central Jail,3372,3,3375,2718,114,2832,4,0,4,22,0,22,6116,117,6233
1,Andhra Pradesh,2001,District Jail,294,1,295,2379,136,2515,0,0,0,0,0,0,2673,137,2810
2,Andhra Pradesh,2001,Sub_Jail,188,10,198,3263,151,3414,0,0,0,0,0,0,3451,161,3612
3,Andhra Pradesh,2001,Women Jail,0,88,88,0,81,81,0,1,1,0,0,0,0,170,170
4,Andhra Pradesh,2001,Borstal School,17,0,17,0,0,0,0,0,0,0,0,0,17,0,17
5,Andhra Pradesh,2001,Open Jail,248,0,248,0,0,0,0,0,0,0,0,0,248,0,248
6,Andhra Pradesh,2001,Special Jail,0,0,0,0,0,0,0,0,0,0,0,0,0,0,0
7,Andhra Pradesh,2001,Others,0,0,0,0,0,0,0,0,0,0,0,0,0,0,0
8,Andhra Pradesh,2001,Total,4119,102,4221,8360,482,8842,4,1,5,22,0,22,12505,585,13090
9,Andhra Pradesh,2002,Central Jail,4111,4,4115,3173,157,3330,2,0,2,0,0,0,7286,161,7447
10,Andhra Pradesh,2002,District Jail,250,3,253,1908,108,2016,0,0,0,0,0,0,2158,111,2269
11,Andhra Pradesh,2002,Sub_Jail,114,1,115,2911,200,3111,0,0,0,0,0,0,3025,201,3226
12,Andhra Pradesh,2002,Women Jail,0,143,143,0,92,92,0,0,0,0,0,0,0,235,235
13,Andhra Pradesh,2002,Borstal School,28,0,28,0,0,0,0,0,0,0,0,0,28,0,28
14,Andhra Pradesh,2002,Open Jail,218,0,218,0,0,0,0,0,0,0,0,0,218,0,218
15,Andhra Pradesh,2002,Special Jail,0,0,0,0,0,0,0,0,0,0,0,0,0,0,0
16,Andhra Pradesh,2002,Others,0,0,0,0,0,0,0,0,0,0,0,0,0,0,0
17,Andhra Pradesh,2002,Total,4721,151,4872,7992,557,8549,2,0,2,0,0,0,12715,708,13423
18,Andhra Pradesh,2003,Central Jail,4305,11,4316,3280,202,3482,18,0,18,0,0,0,7603,213,7816
19,Andhra Pradesh,2003,District Jail,269,0,269,1927,165,2092,0,0,0,0,0,0,2196,165,2361
20,Andhra Pradesh,2003,Sub_Jail,125,0,125,3171,22,3193,0,0,0,0,0,0,3296,22,3318
21,Andhra Pradesh,2003,Women Jail,0,161,161,0,152,152,0,0,0,0,0,0,0,313,313
22,Andhra Pradesh,2003,Borstal School,22,0,22,0,0,0,0,0,0,0,0,0,22,0,22
23,Andhra Pradesh,2003,Open Jail,254,0,254,0,0,0,0,0,0,0,0,0,254,0,254
24,Andhra Pradesh,2003,Special Jail,0,0,0,0,0,0,0,0,0,0,0,0,0,0,0
25,Andhra Pradesh,2003,Others,0,0,0,0,0,0,0,0,0,0,0,0,0,0,0
26,Andhra Pradesh,2003,Total,4975,172,5147,8378,541,8919,18,0,18,0,0,0,13371,713,14084
27,Andhra Pradesh,2004,Central Jail,3949,15,3964,3401,194,3595,27,0,27,0,0,0,7377,209,7586
28,Andhra Pradesh,2004,District Jail,224,6,230,2063,174,2237,2,0,2,0,0,0,2289,180,2469
29,Andhra Pradesh,2004,Sub_Jail,105,2,107,3035,40,3075,0,0,0,0,0,0,3140,42,3182
30,Andhra Pradesh,2004,Women Jail,0,174,174,0,171,171,0,9,9,0,0,0,0,354,354
31,Andhra Pradesh,2004,Borstal School,6,0,6,0,0,0,0,0,0,0,0,0,6,0,6
32,Andhra Pradesh,2004,Open Jail,284,0,284,0,0,0,0,0,0,0,0,0,284,0,284
33,Andhra Pradesh,2004,Special Jail,0,0,0,0,0,0,0,0,0,0,0,0,0,0,0
34,Andhra Pradesh,2004,Others,0,0,0,0,0,0,0,0,0,0,0,0,0,0,0
35,Andhra Pradesh,2004,Total,4568,197,4765,8499,579,9078,29,9,38,0,0,0,13096,785,13881
36,Andhra Pradesh,2005,Central Jail,4152,9,4161,3897,132,4029,10,0,10,0,0,0,8059,141,8200
37,Andhra Pradesh,2005,District Jail,219,4,223,1871,218,2089,0,0,0,0,0,0,2090,222,2312
38,Andhra Pradesh,2005,Sub_Jail,145,1,146,3138,50,3188,0,0,0,0,0,0,3283,51,3334
39,Andhra Pradesh,2005,Women Jail,0,184,184,0,286,286,0,0,0,0,0,0,0,470,470
40,Andhra Pradesh,2005,Borstal School,7,0,7,0,0,0,0,0,0,0,0,0,7,0,7
41,Andhra Pradesh,2005,Open Jail,290,0,290,0,0,0,0,0,0,0,0,0,290,0,290
42,Andhra Pradesh,2005,Special Jail,0,0,0,0,0,0,0,0,0,0,0,0,0,0,0
43,Andhra Pradesh,2005,Others,0,0,0,0,0,0,0,0,0,0,0,0,0,0,0
44,Andhra Pradesh,2005,Total,4813,198,5011,8906,686,9592,10,0,10,0,0,0,13729,884,14613
45,Andhra Pradesh,2006,Central Jail,4271,8,4279,3674,150,3824,17,0,17,34,0,34,7996,158,8154
46,Andhra Pradesh,2006,District Jail,368,6,374,2203,233,2436,0,0,0,0,0,0,2571,239,2810
47,Andhra Pradesh,2006,Sub_Jail,92,1,93,3568,75,3643,0,0,0,0,0,0,3660,76,3736
48,Andhra Pradesh,2006,Women Jail,0,192,192,0,179,179,0,1,1,0,0,0,0,372,372
49,Andhra Pradesh,2006,Borstal School,14,0,14,0,0,0,0,0,0,0,0,0,14,0,14
50,Andhra Pradesh,2006,Open Jail,335,0,335,0,0,0,0,0,0,0,0,0,335,0,335
51,Andhra Pradesh,2006,Special Jail,0,0,0,0,0,0,0,0,0,0,0,0,0,0,0
52,Andhra Pradesh,2006,Others,0,0,0,0,0,0,0,0,0,0,0,0,0,0,0
53,Andhra Pradesh,2006,Total,5080,207,5287,9445,637,10082,17,1,18,34,0,34,14576,845,15421
54,Andhra Pradesh,2007,Central Jail,4582,30,4612,3469,117,3586,21,0,21,20,0,20,8092,147,8239
55,Andhra Pradesh,2007,District Jail,291,7,298,2081,195,2276,0,0,0,0,0,0,2372,202,2574
56,Andhra Pradesh,2007,Sub_Jail,107,0,107,3260,155,3415,0,0,0,0,0,0,3367,155,3522
57,Andhra Pradesh,2007,Women Jail,0,195,195,0,168,168,0,0,0,0,0,0,0,363,363
58,Andhra Pradesh,2007,Borstal School,13,0,13,0,0,0,0,0,0,0,0,0,13,0,13
59,Andhra Pradesh,2007,Open Jail,334,0,334,0,0,0,0,0,0,0,0,0,334,0,334
60,Andhra Pradesh,2007,Special Jail,0,0,0,0,0,0,0,0,0,0,0,0,0,0,0
61,Andhra Pradesh,2007,Others,0,0,0,0,0,0,0,0,0,0,0,0,0,0,0
62,Andhra Pradesh,2007,Total,5327,232,5559,8810,635,9445,21,0,21,20,0,20,14178,867,15045
63,Andhra Pradesh,2008,Central Jail,4436,31,4467,3148,87,3235,21,0,21,12,0,12,7617,118,7735
64,Andhra Pradesh,2008,District Jail,286,5,291,1956,179,2135,0,0,0,0,0,0,2242,184,2426
65,Andhra Pradesh,2008,Sub_Jail,86,0,86,2914,240,3154,0,0,0,0,0,0,3000,240,3240
66,Andhra Pradesh,2008,Women Jail,0,187,187,0,145,145,0,0,0,0,0,0,0,332,332
67,Andhra Pradesh,2008,Borstal School,7,0,7,0,0,0,0,0,0,0,0,0,7,0,7
68,Andhra Pradesh,2008,Open Jail,340,0,340,0,0,0,0,0,0,0,0,0,340,0,340
69,Andhra Pradesh,2008,Special Jail,0,0,0,0,0,0,0,0,0,0,0,0,0,0,0
70,Andhra Pradesh,2008,Others,0,0,0,0,0,0,0,0,0,0,0,0,0,0,0
71,Andhra Pradesh,2008,Total,5155,223,5378,8018,651,8669,21,0,21,12,0,12,13206,874,14080
72,Andhra Pradesh,2009,Central Jail,3704,99,3803,2713,77,2790,38,0,38,15,0,15,6470,176,6646
73,Andhra Pradesh,2009,District Jail,241,1,242,1915,159,2074,0,0,0,0,0,0,2156,160,2316
74,Andhra Pradesh,2009,Sub_Jail,77,1,78,3012,212,3224,0,0,0,0,0,0,3089,213,3302
75,Andhra Pradesh,2009,Women Jail,0,96,96,0,129,129,0,2,2,0,0,0,0,227,227
76,Andhra Pradesh,2009,Borstal School,12,0,12,0,0,0,0,0,0,0,0,0,12,0,12
77,Andhra Pradesh,2009,Open Jail,305,0,305,0,0,0,0,0,0,0,0,0,305,0,305
78,Andhra Pradesh,2009,Special Jail,0,0,0,0,0,0,0,0,0,0,0,0,0,0,0
79,Andhra Pradesh,2009,Others,0,0,0,0,0,0,0,0,0,0,0,0,0,0,0
80,Andhra Pradesh,2009,Total,4339,197,4536,7640,577,8217,38,2,40,15,0,15,12032,776,12808
81,Andhra Pradesh,2010,Central Jail,3938,71,4009,2823,67,2890,28,0,28,13,0,13,6802,138,6940
82,Andhra Pradesh,2010,District Jail,195,1,196,1594,161,1755,0,0,0,0,0,0,1789,162,1951
83,Andhra Pradesh,2010,Sub_Jail,83,2,85,2686,189,2875,0,0,0,0,0,0,2769,191,2960
84,Andhra Pradesh,2010,Women Jail,0,157,157,0,129,129,0,2,2,0,0,0,0,288,288
85,Andhra Pradesh,2010,Borstal School,13,0,13,0,0,0,0,0,0,0,0,0,13,0,13
86,Andhra Pradesh,2010,Open Jail,338,0,338,0,0,0,0,0,0,0,0,0,338,0,338
87,Andhra Pradesh,2010,Special Jail,0,0,0,0,0,0,0,0,0,0,0,0,0,0,0
88,Andhra Pradesh,2010,Others,0,0,0,0,0,0,0,0,0,0,0,0,0,0,0
89,Andhra Pradesh,2010,Total,4567,231,4798,7103,546,7649,28,2,30,13,0,13,11711,779,12490
90,Andhra Pradesh,2011,Central Jail,3774,92,3866,3140,54,3194,13,0,13,17,0,17,6944,146,7090
91,Andhra Pradesh,2011,District Jail,270,3,273,2005,174,2179,0,0,0,0,0,0,2275,177,2452
92,Andhra Pradesh,2011,Sub_Jail,48,1,49,2819,209,3028,0,0,0,0,0,0,2867,210,3077
93,Andhra Pradesh,2011,Women Jail,0,165,165,0,143,143,0,1,1,0,0,0,0,309,309
94,Andhra Pradesh,2011,Borstal School,6,0,6,0,0,0,0,0,0,0,0,0,6,0,6
95,Andhra Pradesh,2011,Open Jail,279,0,279,0,0,0,0,0,0,0,0,0,279,0,279
96,Andhra Pradesh,2011,Special Jail,0,0,0,0,0,0,0,0,0,0,0,0,0,0,0
97,Andhra Pradesh,2011,Others,0,0,0,0,0,0,0,0,0,0,0,0,0,0,0
98,Andhra Pradesh,2011,Total,4377,261,4638,7964,580,8544,13,1,14,17,0,17,12371,842,13213
99,Andhra Pradesh,2012,Central Jail,3810,115,3925,2903,97,3000,3,0,3,7,1,8,6723,213,6936
100,Andhra Pradesh,2012,District Jail,251,1,252,1904,164,2068,0,0,0,0,0,0,2155,165,2320
101,Andhra Pradesh,2012,Sub_Jail,48,1,49,3107,233,3340,0,0,0,0,0,0,3155,234,3389
102,Andhra Pradesh,2012,Women Jail,0,168,168,0,143,143,0,1,1,0,0,0,0,312,312
103,Andhra Pradesh,2012,Borstal School,5,0,5,0,0,0,0,0,0,0,0,0,5,0,5
104,Andhra Pradesh,2012,Open Jail,323,0,323,0,0,0,0,0,0,0,0,0,323,0,323
105,Andhra Pradesh,2012,Special Jail,0,0,0,0,0,0,0,0,0,0,0,0,0,0,0
106,Andhra Pradesh,2012,Others,0,0,0,0,0,0,0,0,0,0,0,0,0,0,0
107,Andhra Pradesh,2012,Total,4437,285,4722,7914,637,8551,3,1,4,7,1,8,12361,924,13285
108,Arunachal Pradesh,2009,Central Jail,0,0,0,0,0,0,0,0,0,0,0,0,0,0,0
109,Arunachal Pradesh,2009,District Jail,2,0,2,56,4,60,0,0,0,0,0,0,58,4,62
110,Arunachal Pradesh,2009,Sub_Jail,0,0,0,0,0,0,0,0,0,0,0,0,0,0,0
111,Arunachal Pradesh,2009,Women Jail,0,0,0,0,0,0,0,0,0,0,0,0,0,0,0
112,Arunachal Pradesh,2009,Borstal School,0,0,0,0,0,0,0,0,0,0,0,0,0,0,0
113,Arunachal Pradesh,2009,Open Jail,0,0,0,0,0,0,0,0,0,0,0,0,0,0,0
114,Arunachal Pradesh,2009,Special Jail,0,0,0,0,0,0,0,0,0,0,0,0,0,0,0
115,Arunachal Pradesh,2009,Others,0,0,0,0,0,0,0,0,0,0,0,0,0,0,0
116,Arunachal Pradesh,2009,Total,2,0,2,56,4,60,0,0,0,0,0,0,58,4,62
117,Arunachal Pradesh,2010,Central Jail,0,0,0,0,0,0,0,0,0,0,0,0,0,0,0
118,Arunachal Pradesh,2010,District Jail,5,0,5,48,4,52,0,0,0,0,0,0,53,4,57
119,Arunachal Pradesh,2010,Sub_Jail,0,0,0,0,0,0,0,0,0,0,0,0,0,0,0
120,Arunachal Pradesh,2010,Women Jail,0,0,0,0,0,0,0,0,0,0,0,0,0,0,0
121,Arunachal Pradesh,2010,Borstal School,0,0,0,0,0,0,0,0,0,0,0,0,0,0,0
122,Arunachal Pradesh,2010,Open Jail,0,0,0,0,0,0,0,0,0,0,0,0,0,0,0
123,Arunachal Pradesh,2010,Special Jail,0,0,0,0,0,0,0,0,0,0,0,0,0,0,0
124,Arunachal Pradesh,2010,Others,0,0,0,0,0,0,0,0,0,0,0,0,0,0,0
125,Arunachal Pradesh,2010,Total,5,0,5,48,4,52,0,0,0,0,0,0,53,4,57
126,Arunachal Pradesh,2011,Central Jail,0,0,0,0,0,0,0,0,0,0,0,0,0,0,0
127,Arunachal Pradesh,2011,District Jail,6,0,6,44,5,49,0,0,0,0,0,0,50,5,55
128,Arunachal Pradesh,2011,Sub_Jail,0,0,0,0,0,0,0,0,0,0,0,0,0,0,0
129,Arunachal Pradesh,2011,Women Jail,0,0,0,0,0,0,0,0,0,0,0,0,0,0,0
130,Arunachal Pradesh,2011,Borstal School,0,0,0,0,0,0,0,0,0,0,0,0,0,0,0
131,Arunachal Pradesh,2011,Open Jail,0,0,0,0,0,0,0,0,0,0,0,0,0,0,0
132,Arunachal Pradesh,2011,Special Jail,0,0,0,0,0,0,0,0,0,0,0,0,0,0,0
133,Arunachal Pradesh,2011,Others,0,0,0,0,0,0,0,0,0,0,0,0,0,0,0
134,Arunachal Pradesh,2011,Total,6,0,6,44,5,49,0,0,0,0,0,0,50,5,55
135,Arunachal Pradesh,2012,Central Jail,0,0,0,0,0,0,0,0,0,0,0,0,0,0,0
136,Arunachal Pradesh,2012,District Jail,4,0,4,63,4,67,0,0,0,0,0,0,67,4,71
137,Arunachal Pradesh,2012,Sub_Jail,0,0,0,0,0,0,0,0,0,0,0,0,0,0,0
138,Arunachal Pradesh,2012,Women Jail,0,0,0,0,0,0,0,0,0,0,0,0,0,0,0
139,Arunachal Pradesh,2012,Borstal School,0,0,0,0,0,0,0,0,0,0,0,0,0,0,0
140,Arunachal Pradesh,2012,Open Jail,0,0,0,0,0,0,0,0,0,0,0,0,0,0,0
141,Arunachal Pradesh,2012,Special Jail,0,0,0,0,0,0,0,0,0,0,0,0,0,0,0
142,Arunachal Pradesh,2012,Others,0,0,0,0,0,0,0,0,0,0,0,0,0,0,0
143,Arunachal Pradesh,2012,Total,4,0,4,63,4,67,0,0,0,0,0,0,67,4,71
144,Assam,2001,Central Jail,0,0,0,0,0,0,0,0,0,0,0,0,0,0,0
145,Assam,2001,District Jail,2282,45,2327,3779,114,3893,14,0,14,1,0,1,6076,159,6235
146,Assam,2001,Sub_Jail,0,0,0,0,0,0,0,0,0,0,0,0,0,0,0
147,Assam,2001,Women Jail,0,0,0,0,0,0,0,0,0,0,0,0,0,0,0
148,Assam,2001,Borstal School,0,0,0,0,0,0,0,0,0,0,0,0,0,0,0
149,Assam,2001,Open Jail,36,0,36,0,0,0,0,0,0,0,0,0,36,0,36
150,Assam,2001,Special Jail,36,2,38,126,13,139,2,0,2,0,0,0,164,15,179
151,Assam,2001,Others,2,0,2,33,0,33,0,0,0,0,0,0,35,0,35
152,Assam,2001,Total,2356,47,2403,3938,127,4065,16,0,16,1,0,1,6311,174,6485
153,Assam,2002,Central Jail,1493,25,1518,1916,68,1984,7,0,7,0,0,0,3416,93,3509
154,Assam,2002,District Jail,994,25,1019,2016,43,2059,10,0,10,0,0,0,3020,68,3088
155,Assam,2002,Sub_Jail,0,0,0,34,0,34,0,0,0,0,0,0,34,0,34
156,Assam,2002,Women Jail,0,0,0,0,0,0,0,0,0,0,0,0,0,0,0
157,Assam,2002,Borstal School,0,0,0,0,0,0,0,0,0,0,0,0,0,0,0
158,Assam,2002,Open Jail,43,0,43,0,0,0,0,0,0,0,0,0,43,0,43
159,Assam,2002,Special Jail,146,4,150,240,2,242,1,0,1,0,0,0,387,6,393
160,Assam,2002,Others,0,0,0,0,0,0,0,0,0,0,0,0,0,0,0
161,Assam,2002,Total,2676,54,2730,4206,113,4319,18,0,18,0,0,0,6900,167,7067
162,Assam,2003,Central Jail,1490,39,1529,2111,58,2169,18,0,18,0,0,0,3619,97,3716
163,Assam,2003,District Jail,1261,32,1293,2056,76,2132,10,2,12,1,0,1,3328,110,3438
164,Assam,2003,Sub_Jail,1,0,1,22,0,22,0,0,0,0,0,0,23,0,23
165,Assam,2003,Women Jail,0,0,0,0,0,0,0,0,0,0,0,0,0,0,0
166,Assam,2003,Borstal School,0,0,0,0,0,0,0,0,0,0,0,0,0,0,0
167,Assam,2003,Open Jail,43,0,43,0,0,0,0,0,0,0,0,0,43,0,43
168,Assam,2003,Special Jail,213,1,214,197,3,200,1,0,1,2,0,2,413,4,417
169,Assam,2003,Others,0,0,0,0,0,0,0,0,0,0,0,0,0,0,0
170,Assam,2003,Total,3008,72,3080,4386,137,4523,29,2,31,3,0,3,7426,211,7637
171,Assam,2004,Central Jail,1603,42,1645,1989,43,2032,90,22,112,4,0,4,3686,107,3793
172,Assam,2004,District Jail,1338,35,1373,1914,82,1996,105,13,118,1,0,1,3358,130,3488
173,Assam,2004,Sub_Jail,2,0,2,27,0,27,0,0,0,0,0,0,29,0,29
174,Assam,2004,Women Jail,0,0,0,0,0,0,0,0,0,0,0,0,0,0,0
175,Assam,2004,Borstal School,0,0,0,0,0,0,0,0,0,0,0,0,0,0,0
176,Assam,2004,Open Jail,34,0,34,0,0,0,0,0,0,0,0,0,34,0,34
177,Assam,2004,Special Jail,214,0,214,234,9,243,20,5,25,2,0,2,470,14,484
178,Assam,2004,Others,0,0,0,0,0,0,0,0,0,0,0,0,0,0,0
179,Assam,2004,Total,3191,77,3268,4164,134,4298,215,40,255,7,0,7,7577,251,7828
180,Assam,2005,Central Jail,1675,35,1710,2376,61,2437,19,3,22,0,0,0,4070,99,4169
181,Assam,2005,District Jail,1499,40,1539,2309,68,2377,7,0,7,4,0,4,3819,108,3927
182,Assam,2005,Sub_Jail,4,0,4,28,0,28,0,0,0,0,0,0,32,0,32
183,Assam,2005,Women Jail,0,0,0,0,0,0,0,0,0,0,0,0,0,0,0
184,Assam,2005,Borstal School,0,0,0,0,0,0,0,0,0,0,0,0,0,0,0
185,Assam,2005,Open Jail,28,0,28,0,0,0,0,0,0,0,0,0,28,0,28
186,Assam,2005,Special Jail,191,3,194,154,4,158,5,0,5,0,0,0,350,7,357
187,Assam,2005,Others,0,0,0,0,0,0,0,0,0,0,0,0,0,0,0
188,Assam,2005,Total,3397,78,3475,4867,133,5000,31,3,34,4,0,4,8299,214,8513
189,Assam,2006,Central Jail,1629,38,1667,2236,62,2298,19,0,19,0,0,0,3884,100,3984
190,Assam,2006,District Jail,1653,45,1698,2341,95,2436,7,0,7,2,0,2,4003,140,4143
191,Assam,2006,Sub_Jail,2,0,2,56,1,57,0,0,0,0,0,0,58,1,59
192,Assam,2006,Women Jail,0,0,0,0,0,0,0,0,0,0,0,0,0,0,0
193,Assam,2006,Borstal School,0,0,0,0,0,0,0,0,0,0,0,0,0,0,0
194,Assam,2006,Open Jail,43,0,43,0,0,0,0,0,0,0,0,0,43,0,43
195,Assam,2006,Special Jail,138,1,139,168,1,169,1,0,1,0,0,0,307,2,309
196,Assam,2006,Others,0,0,0,0,0,0,0,0,0,0,0,0,0,0,0
197,Assam,2006,Total,3465,84,3549,4801,159,4960,27,0,27,2,0,2,8295,243,8538
198,Assam,2007,Central Jail,1588,41,1629,2335,57,2392,19,4,23,0,0,0,3942,102,4044
199,Assam,2007,District Jail,1724,53,1777,2459,84,2543,6,1,7,0,0,0,4189,138,4327
200,Assam,2007,Sub_Jail,6,0,6,49,0,49,1,0,1,0,0,0,56,0,56
201,Assam,2007,Women Jail,0,0,0,0,0,0,0,0,0,0,0,0,0,0,0
202,Assam,2007,Borstal School,0,0,0,0,0,0,0,0,0,0,0,0,0,0,0
203,Assam,2007,Open Jail,38,0,38,0,0,0,0,0,0,0,0,0,38,0,38
204,Assam,2007,Special Jail,124,6,130,101,5,106,4,0,4,0,0,0,229,11,240
205,Assam,2007,Others,0,0,0,0,0,0,0,0,0,0,0,0,0,0,0
206,Assam,2007,Total,3480,100,3580,4944,146,5090,30,5,35,0,0,0,8454,251,8705
207,Assam,2008,Central Jail,1539,42,1581,2300,84,2384,8,0,8,0,0,0,3847,126,3973
208,Assam,2008,District Jail,1717,54,1771,2575,123,2698,1,0,1,0,0,0,4293,177,4470
209,Assam,2008,Sub_Jail,5,0,5,59,1,60,0,0,0,0,0,0,64,1,65
210,Assam,2008,Women Jail,0,0,0,0,0,0,0,0,0,0,0,0,0,0,0
211,Assam,2008,Borstal School,0,0,0,0,0,0,0,0,0,0,0,0,0,0,0
212,Assam,2008,Open Jail,43,0,43,0,0,0,0,0,0,0,0,0,43,0,43
213,Assam,2008,Special Jail,92,2,94,89,7,96,1,0,1,0,0,0,182,9,191
214,Assam,2008,Others,0,0,0,0,0,0,0,0,0,0,0,0,0,0,0
215,Assam,2008,Total,3396,98,3494,5023,215,5238,10,0,10,0,0,0,8429,313,8742
216,Assam,2009,Central Jail,1350,35,1385,1644,67,1711,7,0,7,0,0,0,3001,102,3103
217,Assam,2009,District Jail,1784,57,1841,2778,123,2901,0,2,2,0,0,0,4562,182,4744
218,Assam,2009,Sub_Jail,2,0,2,45,0,45,0,0,0,0,0,0,47,0,47
219,Assam,2009,Women Jail,0,0,0,0,0,0,0,0,0,0,0,0,0,0,0
220,Assam,2009,Borstal School,0,0,0,0,0,0,0,0,0,0,0,0,0,0,0
221,Assam,2009,Open Jail,35,0,35,0,0,0,0,0,0,0,0,0,35,0,35
222,Assam,2009,Special Jail,64,0,64,152,15,167,0,0,0,0,0,0,216,15,231
223,Assam,2009,Others,0,0,0,0,0,0,0,0,0,0,0,0,0,0,0
224,Assam,2009,Total,3235,92,3327,4619,205,4824,7,2,9,0,0,0,7861,299,8160
225,Assam,2010,Central Jail,1258,37,1295,1700,67,1767,3,0,3,0,0,0,2961,104,3065
226,Assam,2010,District Jail,1812,61,1873,2545,108,2653,0,0,0,0,0,0,4357,169,4526
227,Assam,2010,Sub_Jail,2,0,2,54,0,54,0,0,0,0,0,0,56,0,56
228,Assam,2010,Women Jail,0,0,0,0,0,0,0,0,0,0,0,0,0,0,0
229,Assam,2010,Borstal School,0,0,0,0,0,0,0,0,0,0,0,0,0,0,0
230,Assam,2010,Open Jail,28,0,28,0,0,0,0,0,0,0,0,0,28,0,28
231,Assam,2010,Special Jail,66,0,66,181,0,181,0,0,0,0,0,0,247,0,247
232,Assam,2010,Others,0,0,0,0,0,0,0,0,0,0,0,0,0,0,0
233,Assam,2010,Total,3166,98,3264,4480,175,4655,3,0,3,0,0,0,7649,273,7922
234,Assam,2011,Central Jail,1271,35,1306,1905,87,1992,0,0,0,0,0,0,3176,122,3298
235,Assam,2011,District Jail,1683,55,1738,2756,119,2875,0,0,0,0,0,0,4439,174,4613
236,Assam,2011,Sub_Jail,3,0,3,72,1,73,0,0,0,0,0,0,75,1,76
237,Assam,2011,Women Jail,0,0,0,0,0,0,0,0,0,0,0,0,0,0,0
238,Assam,2011,Borstal School,0,0,0,0,0,0,0,0,0,0,0,0,0,0,0
239,Assam,2011,Open Jail,23,0,23,0,0,0,0,0,0,0,0,0,23,0,23
240,Assam,2011,Special Jail,66,1,67,126,0,126,0,0,0,0,0,0,192,1,193
241,Assam,2011,Others,0,0,0,0,0,0,0,0,0,0,0,0,0,0,0
242,Assam,2011,Total,3046,91,3137,4859,207,5066,0,0,0,0,0,0,7905,298,8203
243,Assam,2012,Central Jail,1203,37,1240,1819,70,1889,1,0,1,0,0,0,3023,107,3130
244,Assam,2012,District Jail,1760,71,1831,2886,106,2992,2,0,2,0,0,0,4648,177,4825
245,Assam,2012,Sub_Jail,1,0,1,76,0,76,0,0,0,0,0,0,77,0,77
246,Assam,2012,Women Jail,0,0,0,0,0,0,0,0,0,0,0,0,0,0,0
247,Assam,2012,Borstal School,0,0,0,0,0,0,0,0,0,0,0,0,0,0,0
248,Assam,2012,Open Jail,31,0,31,0,0,0,0,0,0,0,0,0,31,0,31
249,Assam,2012,Special Jail,67,0,67,134,7,141,0,0,0,0,0,0,201,7,208
250,Assam,2012,Others,0,0,0,0,0,0,0,0,0,0,0,0,0,0,0
251,Assam,2012,Total,3062,108,3170,4915,183,5098,3,0,3,0,0,0,7980,291,8271
252,Bihar,2001,Central Jail,3712,21,3733,6084,63,6147,4,0,4,4,0,4,9804,84,9888
253,Bihar,2001,District Jail,1072,9,1081,17139,546,17685,8,0,8,30,0,30,18249,555,18804
254,Bihar,2001,Sub_Jail,203,2,205,6777,156,6933,0,0,0,3,0,3,6983,158,7141
255,Bihar,2001,Women Jail,0,46,46,0,28,28,0,0,0,0,0,0,0,74,74
256,Bihar,2001,Borstal School,0,0,0,0,0,0,0,0,0,0,0,0,0,0,0
257,Bihar,2001,Open Jail,0,0,0,0,0,0,0,0,0,0,0,0,0,0,0
258,Bihar,2001,Special Jail,0,0,0,0,0,0,0,0,0,0,0,0,0,0,0
259,Bihar,2001,Others,0,0,0,0,0,0,0,0,0,0,0,0,0,0,0
260,Bihar,2001,Total,4987,78,5065,30000,793,30793,12,0,12,37,0,37,35036,871,35907
261,Bihar,2002,Central Jail,3799,19,3818,6924,108,7032,5,0,5,36,0,36,10764,127,10891
262,Bihar,2002,District Jail,1005,16,1021,17249,629,17878,15,0,15,63,0,63,18332,645,18977
263,Bihar,2002,Sub_Jail,155,1,156,6986,173,7159,13,0,13,3,0,3,7157,174,7331
264,Bihar,2002,Women Jail,0,69,69,0,32,32,0,0,0,0,0,0,0,101,101
265,Bihar,2002,Borstal School,0,0,0,0,0,0,0,0,0,0,0,0,0,0,0
266,Bihar,2002,Open Jail,0,0,0,0,0,0,0,0,0,0,0,0,0,0,0
267,Bihar,2002,Special Jail,0,0,0,0,0,0,0,0,0,0,0,0,0,0,0
268,Bihar,2002,Others,0,0,0,0,0,0,0,0,0,0,0,0,0,0,0
269,Bihar,2002,Total,4959,105,5064,31159,942,32101,33,0,33,102,0,102,36253,1047,37300
270,Bihar,2003,Central Jail,3712,18,3730,6721,93,6814,1,0,1,24,0,24,10458,111,10569
271,Bihar,2003,District Jail,1065,25,1090,17880,619,18499,21,0,21,61,0,61,19027,644,19671
272,Bihar,2003,Sub_Jail,197,2,199,6588,186,6774,0,0,0,4,0,4,6789,188,6977
273,Bihar,2003,Women Jail,0,59,59,0,47,47,0,0,0,0,0,0,0,106,106
274,Bihar,2003,Borstal School,0,0,0,0,0,0,0,0,0,0,0,0,0,0,0
275,Bihar,2003,Open Jail,0,0,0,0,0,0,0,0,0,0,0,0,0,0,0
276,Bihar,2003,Special Jail,0,0,0,0,0,0,0,0,0,0,0,0,0,0,0
277,Bihar,2003,Others,0,0,0,0,0,0,0,0,0,0,0,0,0,0,0
278,Bihar,2003,Total,4974,104,5078,31189,945,32134,22,0,22,89,0,89,36274,1049,37323
279,Bihar,2004,Central Jail,3959,35,3994,6441,174,6615,24,0,24,40,0,40,10464,209,10673
280,Bihar,2004,District Jail,1107,21,1128,14426,397,14823,36,0,36,70,0,70,15639,418,16057
281,Bihar,2004,Sub_Jail,324,5,329,5765,146,5911,5,0,5,3,0,3,6097,151,6248
282,Bihar,2004,Women Jail,0,69,69,0,26,26,0,0,0,0,0,0,0,95,95
283,Bihar,2004,Borstal School,0,0,0,0,0,0,0,0,0,0,0,0,0,0,0
284,Bihar,2004,Open Jail,0,0,0,0,0,0,0,0,0,0,0,0,0,0,0
285,Bihar,2004,Special Jail,0,0,0,0,0,0,0,0,0,0,0,0,0,0,0
286,Bihar,2004,Others,0,0,0,0,0,0,0,0,0,0,0,0,0,0,0
287,Bihar,2004,Total,5390,130,5520,26632,743,27375,65,0,65,113,0,113,32200,873,33073
288,Bihar,2005,Central Jail,3978,30,4008,8870,254,9124,0,0,0,29,0,29,12877,284,13161
289,Bihar,2005,District Jail,1174,27,1201,21242,677,21919,0,0,0,136,0,136,22552,704,23256
290,Bihar,2005,Sub_Jail,333,10,343,8709,227,8936,0,0,0,25,0,25,9067,237,9304
291,Bihar,2005,Women Jail,0,57,57,0,40,40,0,0,0,0,0,0,0,97,97
292,Bihar,2005,Borstal School,0,0,0,0,0,0,0,0,0,0,0,0,0,0,0
293,Bihar,2005,Open Jail,0,0,0,0,0,0,0,0,0,0,0,0,0,0,0
294,Bihar,2005,Special Jail,0,0,0,0,0,0,0,0,0,0,0,0,0,0,0
295,Bihar,2005,Others,0,0,0,0,0,0,0,0,0,0,0,0,0,0,0
296,Bihar,2005,Total,5485,124,5609,38821,1198,40019,0,0,0,190,0,190,44496,1322,45818
297,Bihar,2006,Central Jail,4418,50,4468,8087,222,8309,0,0,0,38,0,38,12543,272,12815
298,Bihar,2006,District Jail,1577,26,1603,19942,731,20673,0,0,0,94,0,94,21613,757,22370
299,Bihar,2006,Sub_Jail,621,10,631,8077,291,8368,0,0,0,9,0,9,8707,301,9008
300,Bihar,2006,Women Jail,0,63,63,0,25,25,0,0,0,0,0,0,0,88,88
301,Bihar,2006,Borstal School,0,0,0,0,0,0,0,0,0,0,0,0,0,0,0
302,Bihar,2006,Open Jail,0,0,0,0,0,0,0,0,0,0,0,0,0,0,0
303,Bihar,2006,Special Jail,0,0,0,0,0,0,0,0,0,0,0,0,0,0,0
304,Bihar,2006,Others,0,0,0,0,0,0,0,0,0,0,0,0,0,0,0
305,Bihar,2006,Total,6616,149,6765,36106,1269,37375,0,0,0,141,0,141,42863,1418,44281
306,Bihar,2007,Central Jail,4172,29,4201,6775,225,7000,12,0,12,3,0,3,10962,254,11216
307,Bihar,2007,District Jail,1764,31,1795,21540,782,22322,11,0,11,25,0,25,23340,813,24153
308,Bihar,2007,Sub_Jail,194,0,194,3845,117,3962,1,0,1,4,0,4,4044,117,4161
309,Bihar,2007,Women Jail,0,76,76,0,32,32,0,0,0,0,0,0,0,108,108
310,Bihar,2007,Borstal School,0,0,0,0,0,0,0,0,0,0,0,0,0,0,0
311,Bihar,2007,Open Jail,0,0,0,0,0,0,0,0,0,0,0,0,0,0,0
312,Bihar,2007,Special Jail,0,0,0,0,0,0,0,0,0,0,0,0,0,0,0
313,Bihar,2007,Others,0,0,0,0,0,0,0,0,0,0,0,0,0,0,0
314,Bihar,2007,Total,6130,136,6266,32160,1156,33316,24,0,24,32,0,32,38346,1292,39638
315,Bihar,2008,Central Jail,4108,28,4136,6879,229,7108,14,0,14,15,0,15,11016,257,11273
316,Bihar,2008,District Jail,1602,34,1636,20210,732,20942,10,0,10,22,0,22,21844,766,22610
317,Bihar,2008,Sub_Jail,158,1,159,3460,110,3570,0,0,0,2,0,2,3620,111,3731
318,Bihar,2008,Women Jail,0,68,68,0,27,27,0,0,0,0,0,0,0,95,95
319,Bihar,2008,Borstal School,0,0,0,0,0,0,0,0,0,0,0,0,0,0,0
320,Bihar,2008,Open Jail,0,0,0,0,0,0,0,0,0,0,0,0,0,0,0
321,Bihar,2008,Special Jail,0,0,0,0,0,0,0,0,0,0,0,0,0,0,0
322,Bihar,2008,Others,0,0,0,0,0,0,0,0,0,0,0,0,0,0,0
323,Bihar,2008,Total,5868,131,5999,30549,1098,31647,24,0,24,39,0,39,36480,1229,37709
324,Bihar,2009,Central Jail,3646,22,3668,6262,185,6447,6,0,6,2,0,2,9916,207,10123
325,Bihar,2009,District Jail,1658,23,1681,18011,605,18616,4,0,4,4,1,5,19677,629,20306
326,Bihar,2009,Sub_Jail,119,1,120,2973,96,3069,0,0,0,0,0,0,3092,97,3189
327,Bihar,2009,Women Jail,0,62,62,0,31,31,0,0,0,0,0,0,0,93,93
328,Bihar,2009,Borstal School,0,0,0,0,0,0,0,0,0,0,0,0,0,0,0
329,Bihar,2009,Open Jail,0,0,0,0,0,0,0,0,0,0,0,0,0,0,0
330,Bihar,2009,Special Jail,0,0,0,0,0,0,0,0,0,0,0,0,0,0,0
331,Bihar,2009,Others,0,0,0,0,0,0,0,0,0,0,0,0,0,0,0
332,Bihar,2009,Total,5423,108,5531,27246,917,28163,10,0,10,6,1,7,32685,1026,33711
333,Bihar,2010,Central Jail,3402,30,3432,7003,207,7210,10,0,10,3,0,3,10418,237,10655
334,Bihar,2010,District Jail,1610,41,1651,13961,477,14438,22,0,22,12,0,12,15605,518,16123
335,Bihar,2010,Sub_Jail,154,2,156,2625,64,2689,2,0,2,4,0,4,2785,66,2851
336,Bihar,2010,Women Jail,0,46,46,0,25,25,0,0,0,0,0,0,0,71,71
337,Bihar,2010,Borstal School,0,0,0,0,0,0,0,0,0,0,0,0,0,0,0
338,Bihar,2010,Open Jail,0,0,0,0,0,0,0,0,0,0,0,0,0,0,0
339,Bihar,2010,Special Jail,0,0,0,0,0,0,0,0,0,0,0,0,0,0,0
340,Bihar,2010,Others,0,0,0,0,0,0,0,0,0,0,0,0,0,0,0
341,Bihar,2010,Total,5166,119,5285,23589,773,24362,34,0,34,19,0,19,28808,892,29700
342,Bihar,2011,Central Jail,2359,26,2385,6183,201,6384,5,0,5,3,0,3,8550,227,8777
343,Bihar,2011,District Jail,1336,25,1361,13671,484,14155,3,0,3,8,0,8,15018,509,15527
344,Bihar,2011,Sub_Jail,91,1,92,2526,88,2614,0,0,0,2,0,2,2619,89,2708
345,Bihar,2011,Women Jail,0,34,34,0,22,22,0,0,0,0,0,0,0,56,56
346,Bihar,2011,Borstal School,0,0,0,0,0,0,0,0,0,0,0,0,0,0,0
347,Bihar,2011,Open Jail,0,0,0,0,0,0,0,0,0,0,0,0,0,0,0
348,Bihar,2011,Special Jail,722,0,722,242,0,242,0,0,0,0,0,0,964,0,964
349,Bihar,2011,Others,0,0,0,0,0,0,0,0,0,0,0,0,0,0,0
350,Bihar,2011,Total,4508,86,4594,22622,795,23417,8,0,8,13,0,13,27151,881,28032
351,Bihar,2012,Central Jail,2044,37,2081,6616,224,6840,8,0,8,0,0,0,8668,261,8929
352,Bihar,2012,District Jail,1208,30,1238,13623,474,14097,32,0,32,13,0,13,14876,504,15380
353,Bihar,2012,Sub_Jail,111,0,111,2925,97,3022,0,0,0,0,0,0,3036,97,3133
354,Bihar,2012,Women Jail,0,35,35,0,31,31,0,0,0,0,0,0,0,66,66
355,Bihar,2012,Borstal School,0,0,0,0,0,0,0,0,0,0,0,0,0,0,0
356,Bihar,2012,Open Jail,102,0,102,0,0,0,0,0,0,0,0,0,102,0,102
357,Bihar,2012,Special Jail,541,0,541,399,0,399,0,0,0,0,0,0,940,0,940
358,Bihar,2012,Others,0,0,0,0,0,0,0,0,0,0,0,0,0,0,0
359,Bihar,2012,Total,4006,102,4108,23563,826,24389,40,0,40,13,0,13,27622,928,28550
360,Chhattisgarh,2012,Central Jail,5533,240,5773,3837,380,4217,0,0,0,13,0,13,9383,620,10003
361,Chhattisgarh,2012,District Jail,161,4,165,2783,75,2858,0,0,0,4,0,4,2948,79,3027
362,Chhattisgarh,2012,Sub_Jail,26,0,26,1724,0,1724,0,0,0,0,0,0,1750,0,1750
363,Chhattisgarh,2012,Women Jail,0,0,0,0,0,0,0,0,0,0,0,0,0,0,0
364,Chhattisgarh,2012,Borstal School,0,0,0,0,0,0,0,0,0,0,0,0,0,0,0
365,Chhattisgarh,2012,Open Jail,0,0,0,0,0,0,0,0,0,0,0,0,0,0,0
366,Chhattisgarh,2012,Special Jail,0,0,0,0,0,0,0,0,0,0,0,0,0,0,0
367,Chhattisgarh,2012,Others,0,0,0,0,0,0,0,0,0,0,0,0,0,0,0
368,Chhattisgarh,2012,Total,5720,244,5964,8344,455,8799,0,0,0,17,0,17,14081,699,14780
369,Chhattisgarh,2001,Central Jail,4207,185,4392,2043,146,2189,4,0,4,1,1,2,6255,332,6587
370,Chhattisgarh,2001,District Jail,146,0,146,937,58,995,0,0,0,3,0,3,1086,58,1144
371,Chhattisgarh,2001,Sub_Jail,166,0,166,1737,0,1737,0,0,0,4,0,4,1907,0,1907
372,Chhattisgarh,2001,Women Jail,0,0,0,0,0,0,0,0,0,0,0,0,0,0,0
373,Chhattisgarh,2001,Borstal School,0,0,0,0,0,0,0,0,0,0,0,0,0,0,0
374,Chhattisgarh,2001,Open Jail,29,0,29,0,0,0,0,0,0,0,0,0,29,0,29
375,Chhattisgarh,2001,Special Jail,0,0,0,0,0,0,0,0,0,0,0,0,0,0,0
376,Chhattisgarh,2001,Others,0,0,0,0,0,0,0,0,0,0,0,0,0,0,0
377,Chhattisgarh,2001,Total,4548,185,4733,4717,204,4921,4,0,4,8,1,9,9277,390,9667
378,Chhattisgarh,2002,Central Jail,4434,200,4634,1864,162,2026,1,0,1,1,0,1,6300,362,6662
379,Chhattisgarh,2002,District Jail,254,2,256,1253,63,1316,0,0,0,5,0,5,1512,65,1577
380,Chhattisgarh,2002,Sub_Jail,125,0,125,1619,0,1619,0,0,0,2,0,2,1746,0,1746
381,Chhattisgarh,2002,Women Jail,0,0,0,0,0,0,0,0,0,0,0,0,0,0,0
382,Chhattisgarh,2002,Borstal School,0,0,0,0,0,0,0,0,0,0,0,0,0,0,0
383,Chhattisgarh,2002,Open Jail,21,0,21,0,0,0,0,0,0,0,0,0,21,0,21
384,Chhattisgarh,2002,Special Jail,0,0,0,0,0,0,0,0,0,0,0,0,0,0,0
385,Chhattisgarh,2002,Others,0,0,0,0,0,0,0,0,0,0,0,0,0,0,0
386,Chhattisgarh,2002,Total,4834,202,5036,4736,225,4961,1,0,1,8,0,8,9579,427,10006
387,Chhattisgarh,2003,Central Jail,4142,194,4336,1634,115,1749,3,0,3,1,0,1,5780,309,6089
388,Chhattisgarh,2003,District Jail,267,5,272,1045,45,1090,0,0,0,2,0,2,1314,50,1364
389,Chhattisgarh,2003,Sub_Jail,112,0,112,1289,0,1289,0,0,0,7,0,7,1408,0,1408
390,Chhattisgarh,2003,Women Jail,0,0,0,0,0,0,0,0,0,0,0,0,0,0,0
391,Chhattisgarh,2003,Borstal School,0,0,0,0,0,0,0,0,0,0,0,0,0,0,0
392,Chhattisgarh,2003,Open Jail,0,0,0,0,0,0,0,0,0,0,0,0,0,0,0
393,Chhattisgarh,2003,Special Jail,0,0,0,0,0,0,0,0,0,0,0,0,0,0,0
394,Chhattisgarh,2003,Others,0,0,0,0,0,0,0,0,0,0,0,0,0,0,0
395,Chhattisgarh,2003,Total,4521,199,4720,3968,160,4128,3,0,3,10,0,10,8502,359,8861
396,Chhattisgarh,2004,Central Jail,3969,202,4171,1417,133,1550,0,0,0,1,0,1,5387,335,5722
397,Chhattisgarh,2004,District Jail,237,3,240,1099,61,1160,0,0,0,2,0,2,1338,64,1402
398,Chhattisgarh,2004,Sub_Jail,114,0,114,1627,0,1627,0,0,0,8,0,8,1749,0,1749
399,Chhattisgarh,2004,Women Jail,0,0,0,0,0,0,0,0,0,0,0,0,0,0,0
400,Chhattisgarh,2004,Borstal School,0,0,0,0,0,0,0,0,0,0,0,0,0,0,0
401,Chhattisgarh,2004,Open Jail,0,0,0,0,0,0,0,0,0,0,0,0,0,0,0
402,Chhattisgarh,2004,Special Jail,0,0,0,0,0,0,0,0,0,0,0,0,0,0,0
403,Chhattisgarh,2004,Others,0,0,0,0,0,0,0,0,0,0,0,0,0,0,0
404,Chhattisgarh,2004,Total,4320,205,4525,4143,194,4337,0,0,0,11,0,11,8474,399,8873
405,Chhattisgarh,2005,Central Jail,3826,187,4013,2187,173,2360,2,0,2,4,0,4,6019,360,6379
406,Chhattisgarh,2005,District Jail,206,4,210,1411,59,1470,0,0,0,3,0,3,1620,63,1683
407,Chhattisgarh,2005,Sub_Jail,76,0,76,1679,0,1679,0,0,0,4,0,4,1759,0,1759
408,Chhattisgarh,2005,Women Jail,0,0,0,0,0,0,0,0,0,0,0,0,0,0,0
409,Chhattisgarh,2005,Borstal School,0,0,0,0,0,0,0,0,0,0,0,0,0,0,0
410,Chhattisgarh,2005,Open Jail,0,0,0,0,0,0,0,0,0,0,0,0,0,0,0
411,Chhattisgarh,2005,Special Jail,0,0,0,0,0,0,0,0,0,0,0,0,0,0,0
412,Chhattisgarh,2005,Others,0,0,0,0,0,0,0,0,0,0,0,0,0,0,0
413,Chhattisgarh,2005,Total,4108,191,4299,5277,232,5509,2,0,2,11,0,11,9398,423,9821
414,Chhattisgarh,2006,Central Jail,3817,186,4003,2271,210,2481,1,0,1,2,0,2,6091,396,6487
415,Chhattisgarh,2006,District Jail,164,1,165,1490,74,1564,0,0,0,3,0,3,1657,75,1732
416,Chhattisgarh,2006,Sub_Jail,106,0,106,2028,0,2028,0,0,0,6,0,6,2140,0,2140
417,Chhattisgarh,2006,Women Jail,0,0,0,0,0,0,0,0,0,0,0,0,0,0,0
418,Chhattisgarh,2006,Borstal School,0,0,0,0,0,0,0,0,0,0,0,0,0,0,0
419,Chhattisgarh,2006,Open Jail,0,0,0,0,0,0,0,0,0,0,0,0,0,0,0
420,Chhattisgarh,2006,Special Jail,0,0,0,0,0,0,0,0,0,0,0,0,0,0,0
421,Chhattisgarh,2006,Others,0,0,0,0,0,0,0,0,0,0,0,0,0,0,0
422,Chhattisgarh,2006,Total,4087,187,4274,5789,284,6073,1,0,1,11,0,11,9888,471,10359
423,Chhattisgarh,2007,Central Jail,4139,207,4346,2998,231,3229,0,0,0,14,0,14,7151,438,7589
424,Chhattisgarh,2007,District Jail,117,1,118,1551,22,1573,0,0,0,8,0,8,1676,23,1699
425,Chhattisgarh,2007,Sub_Jail,61,0,61,1097,0,1097,0,0,0,5,0,5,1163,0,1163
426,Chhattisgarh,2007,Women Jail,0,0,0,0,0,0,0,0,0,0,0,0,0,0,0
427,Chhattisgarh,2007,Borstal School,0,0,0,0,0,0,0,0,0,0,0,0,0,0,0
428,Chhattisgarh,2007,Open Jail,0,0,0,0,0,0,0,0,0,0,0,0,0,0,0
429,Chhattisgarh,2007,Special Jail,0,0,0,0,0,0,0,0,0,0,0,0,0,0,0
430,Chhattisgarh,2007,Others,0,0,0,0,0,0,0,0,0,0,0,0,0,0,0
431,Chhattisgarh,2007,Total,4317,208,4525,5646,253,5899,0,0,0,27,0,27,9990,461,10451
432,Chhattisgarh,2008,Central Jail,4364,192,4556,3261,272,3533,0,0,0,3,0,3,7628,464,8092
433,Chhattisgarh,2008,District Jail,149,2,151,1681,30,1711,0,0,0,1,0,1,1831,32,1863
434,Chhattisgarh,2008,Sub_Jail,60,0,60,1213,0,1213,0,0,0,2,0,2,1275,0,1275
435,Chhattisgarh,2008,Women Jail,0,0,0,0,0,0,0,0,0,0,0,0,0,0,0
436,Chhattisgarh,2008,Borstal School,0,0,0,0,0,0,0,0,0,0,0,0,0,0,0
437,Chhattisgarh,2008,Open Jail,0,0,0,0,0,0,0,0,0,0,0,0,0,0,0
438,Chhattisgarh,2008,Special Jail,0,0,0,0,0,0,0,0,0,0,0,0,0,0,0
439,Chhattisgarh,2008,Others,0,0,0,0,0,0,0,0,0,0,0,0,0,0,0
440,Chhattisgarh,2008,Total,4573,194,4767,6155,302,6457,0,0,0,6,0,6,10734,496,11230
441,Chhattisgarh,2009,Central Jail,4461,217,4678,3579,305,3884,0,0,0,13,0,13,8053,522,8575
442,Chhattisgarh,2009,District Jail,128,0,128,2014,54,2068,0,0,0,1,0,1,2143,54,2197
443,Chhattisgarh,2009,Sub_Jail,51,0,51,1317,0,1317,0,0,0,2,0,2,1370,0,1370
444,Chhattisgarh,2009,Women Jail,0,0,0,0,0,0,0,0,0,0,0,0,0,0,0
445,Chhattisgarh,2009,Borstal School,0,0,0,0,0,0,0,0,0,0,0,0,0,0,0
446,Chhattisgarh,2009,Open Jail,0,0,0,0,0,0,0,0,0,0,0,0,0,0,0
447,Chhattisgarh,2009,Special Jail,0,0,0,0,0,0,0,0,0,0,0,0,0,0,0
448,Chhattisgarh,2009,Others,0,0,0,0,0,0,0,0,0,0,0,0,0,0,0
449,Chhattisgarh,2009,Total,4640,217,4857,6910,359,7269,0,0,0,16,0,16,11566,576,12142
450,Chhattisgarh,2010,Central Jail,4790,207,4997,3888,331,4219,1,0,1,10,0,10,8689,538,9227
451,Chhattisgarh,2010,District Jail,148,2,150,2364,44,2408,0,0,0,6,0,6,2518,46,2564
452,Chhattisgarh,2010,Sub_Jail,49,0,49,1072,0,1072,0,0,0,3,0,3,1124,0,1124
453,Chhattisgarh,2010,Women Jail,0,0,0,0,0,0,0,0,0,0,0,0,0,0,0
454,Chhattisgarh,2010,Borstal School,0,0,0,0,0,0,0,0,0,0,0,0,0,0,0
455,Chhattisgarh,2010,Open Jail,0,0,0,0,0,0,0,0,0,0,0,0,0,0,0
456,Chhattisgarh,2010,Special Jail,0,0,0,0,0,0,0,0,0,0,0,0,0,0,0
457,Chhattisgarh,2010,Others,0,0,0,0,0,0,0,0,0,0,0,0,0,0,0
458,Chhattisgarh,2010,Total,4987,209,5196,7324,375,7699,1,0,1,19,0,19,12331,584,12915
459,Chhattisgarh,2011,Central Jail,5220,242,5462,4050,344,4394,0,0,0,10,0,10,9280,586,9866
460,Chhattisgarh,2011,District Jail,126,0,126,2695,48,2743,0,0,0,2,0,2,2823,48,2871
461,Chhattisgarh,2011,Sub_Jail,42,0,42,1138,0,1138,0,0,0,1,0,1,1181,0,1181
462,Chhattisgarh,2011,Women Jail,0,0,0,0,0,0,0,0,0,0,0,0,0,0,0
463,Chhattisgarh,2011,Borstal School,0,0,0,0,0,0,0,0,0,0,0,0,0,0,0
464,Chhattisgarh,2011,Open Jail,0,0,0,0,0,0,0,0,0,0,0,0,0,0,0
465,Chhattisgarh,2011,Special Jail,0,0,0,0,0,0,0,0,0,0,0,0,0,0,0
466,Chhattisgarh,2011,Others,0,0,0,0,0,0,0,0,0,0,0,0,0,0,0
467,Chhattisgarh,2011,Total,5388,242,5630,7883,392,8275,0,0,0,13,0,13,13284,634,13918
468,Goa,2001,Central Jail,124,4,128,30,7,37,0,0,0,0,0,0,154,11,165
469,Goa,2001,District Jail,0,0,0,0,0,0,0,0,0,0,0,0,0,0,0
470,Goa,2001,Sub_Jail,30,0,30,152,0,152,0,0,0,0,0,0,182,0,182
471,Goa,2001,Women Jail,0,0,0,0,0,0,0,0,0,0,0,0,0,0,0
472,Goa,2001,Borstal School,0,0,0,0,0,0,0,0,0,0,0,0,0,0,0
473,Goa,2001,Open Jail,0,0,0,0,0,0,0,0,0,0,0,0,0,0,0
474,Goa,2001,Special Jail,0,0,0,0,0,0,0,0,0,0,0,0,0,0,0
475,Goa,2001,Others,0,0,0,105,0,105,0,0,0,0,0,0,105,0,105
476,Goa,2001,Total,154,4,158,287,7,294,0,0,0,0,0,0,441,11,452
477,Goa,2002,Central Jail,136,4,140,17,5,22,0,0,0,0,0,0,153,9,162
478,Goa,2002,District Jail,0,0,0,0,0,0,0,0,0,0,0,0,0,0,0
479,Goa,2002,Sub_Jail,9,0,9,76,0,76,0,0,0,0,0,0,85,0,85
480,Goa,2002,Women Jail,0,0,0,0,0,0,0,0,0,0,0,0,0,0,0
481,Goa,2002,Borstal School,0,0,0,0,0,0,0,0,0,0,0,0,0,0,0
482,Goa,2002,Open Jail,0,0,0,0,0,0,0,0,0,0,0,0,0,0,0
483,Goa,2002,Special Jail,0,0,0,0,0,0,0,0,0,0,0,0,0,0,0
484,Goa,2002,Others,0,0,0,105,0,105,0,0,0,0,0,0,105,0,105
485,Goa,2002,Total,145,4,149,198,5,203,0,0,0,0,0,0,343,9,352
486,Goa,2003,Central Jail,124,3,127,28,9,37,1,0,1,0,0,0,153,12,165
487,Goa,2003,District Jail,0,0,0,0,0,0,0,0,0,0,0,0,0,0,0
488,Goa,2003,Sub_Jail,16,0,16,84,0,84,0,0,0,0,0,0,100,0,100
489,Goa,2003,Women Jail,0,0,0,0,0,0,0,0,0,0,0,0,0,0,0
490,Goa,2003,Borstal School,0,0,0,0,0,0,0,0,0,0,0,0,0,0,0
491,Goa,2003,Open Jail,0,0,0,0,0,0,0,0,0,0,0,0,0,0,0
492,Goa,2003,Special Jail,0,0,0,0,0,0,0,0,0,0,0,0,0,0,0
493,Goa,2003,Others,0,0,0,267,0,267,0,0,0,0,0,0,267,0,267
494,Goa,2003,Total,140,3,143,379,9,388,1,0,1,0,0,0,520,12,532
495,Goa,2004,Central Jail,130,2,132,36,9,45,0,0,0,0,0,0,166,11,177
496,Goa,2004,District Jail,0,0,0,0,0,0,0,0,0,0,0,0,0,0,0
497,Goa,2004,Sub_Jail,18,0,18,108,0,108,0,0,0,0,0,0,126,0,126
498,Goa,2004,Women Jail,0,0,0,0,0,0,0,0,0,0,0,0,0,0,0
499,Goa,2004,Borstal School,0,0,0,0,0,0,0,0,0,0,0,0,0,0,0
500,Goa,2004,Open Jail,0,0,0,0,0,0,0,0,0,0,0,0,0,0,0
501,Goa,2004,Special Jail,0,0,0,0,0,0,0,0,0,0,0,0,0,0,0
502,Goa,2004,Others,0,0,0,124,0,124,0,0,0,0,0,0,124,0,124
503,Goa,2004,Total,148,2,150,268,9,277,0,0,0,0,0,0,416,11,427
504,Goa,2005,Central Jail,125,3,128,0,17,17,0,0,0,0,0,0,125,20,145
505,Goa,2005,District Jail,0,0,0,0,0,0,0,0,0,0,0,0,0,0,0
506,Goa,2005,Sub_Jail,10,0,10,97,0,97,0,0,0,0,0,0,107,0,107
507,Goa,2005,Women Jail,0,0,0,0,0,0,0,0,0,0,0,0,0,0,0
508,Goa,2005,Borstal School,0,0,0,0,0,0,0,0,0,0,0,0,0,0,0
509,Goa,2005,Open Jail,0,0,0,0,0,0,0,0,0,0,0,0,0,0,0
510,Goa,2005,Special Jail,0,0,0,0,0,0,0,0,0,0,0,0,0,0,0
511,Goa,2005,Others,0,0,0,132,0,132,0,0,0,0,0,0,132,0,132
512,Goa,2005,Total,135,3,138,229,17,246,0,0,0,0,0,0,364,20,384
513,Goa,2006,Central Jail,122,2,124,0,18,18,0,0,0,0,0,0,122,20,142
514,Goa,2006,District Jail,0,0,0,0,0,0,0,0,0,0,0,0,0,0,0
515,Goa,2006,Sub_Jail,20,0,20,101,0,101,0,0,0,0,0,0,121,0,121
516,Goa,2006,Women Jail,0,0,0,0,0,0,0,0,0,0,0,0,0,0,0
517,Goa,2006,Borstal School,0,0,0,0,0,0,0,0,0,0,0,0,0,0,0
518,Goa,2006,Open Jail,0,0,0,0,0,0,0,0,0,0,0,0,0,0,0
519,Goa,2006,Special Jail,0,0,0,0,0,0,0,0,0,0,0,0,0,0,0
520,Goa,2006,Others,0,0,0,117,0,117,0,0,0,0,0,0,117,0,117
521,Goa,2006,Total,142,2,144,218,18,236,0,0,0,0,0,0,360,20,380
522,Goa,2007,Central Jail,122,2,124,0,18,18,0,0,0,0,0,0,122,20,142
523,Goa,2007,District Jail,0,0,0,0,0,0,0,0,0,0,0,0,0,0,0
524,Goa,2007,Sub_Jail,23,0,23,76,0,76,0,0,0,0,0,0,99,0,99
525,Goa,2007,Women Jail,0,0,0,0,0,0,0,0,0,0,0,0,0,0,0
526,Goa,2007,Borstal School,0,0,0,0,0,0,0,0,0,0,0,0,0,0,0
527,Goa,2007,Open Jail,0,0,0,0,0,0,0,0,0,0,0,0,0,0,0
528,Goa,2007,Special Jail,0,0,0,0,0,0,0,0,0,0,0,0,0,0,0
529,Goa,2007,Others,0,0,0,125,0,125,0,0,0,0,0,0,125,0,125
530,Goa,2007,Total,145,2,147,201,18,219,0,0,0,0,0,0,346,20,366
531,Goa,2008,Central Jail,118,9,127,0,16,16,0,0,0,0,0,0,118,25,143
532,Goa,2008,District Jail,0,0,0,0,0,0,0,0,0,0,0,0,0,0,0
533,Goa,2008,Sub_Jail,23,0,23,112,0,112,0,0,0,0,0,0,135,0,135
534,Goa,2008,Women Jail,0,0,0,0,0,0,0,0,0,0,0,0,0,0,0
535,Goa,2008,Borstal School,0,0,0,0,0,0,0,0,0,0,0,0,0,0,0
536,Goa,2008,Open Jail,0,0,0,0,0,0,0,0,0,0,0,0,0,0,0
537,Goa,2008,Special Jail,0,0,0,0,0,0,0,0,0,0,0,0,0,0,0
538,Goa,2008,Others,0,0,0,125,0,125,0,0,0,0,0,0,125,0,125
539,Goa,2008,Total,141,9,150,237,16,253,0,0,0,0,0,0,378,25,403
540,Goa,2009,Central Jail,125,7,132,0,24,24,0,0,0,0,0,0,125,31,156
541,Goa,2009,District Jail,0,0,0,0,0,0,0,0,0,0,0,0,0,0,0
542,Goa,2009,Sub_Jail,56,0,56,98,0,98,0,0,0,0,0,0,154,0,154
543,Goa,2009,Women Jail,0,0,0,0,0,0,0,0,0,0,0,0,0,0,0
544,Goa,2009,Borstal School,0,0,0,0,0,0,0,0,0,0,0,0,0,0,0
545,Goa,2009,Open Jail,0,0,0,0,0,0,0,0,0,0,0,0,0,0,0
546,Goa,2009,Special Jail,0,0,0,0,0,0,0,0,0,0,0,0,0,0,0
547,Goa,2009,Others,0,0,0,122,0,122,0,0,0,0,0,0,122,0,122
548,Goa,2009,Total,181,7,188,220,24,244,0,0,0,0,0,0,401,31,432
549,Goa,2010,Central Jail,136,8,144,0,27,27,0,0,0,0,0,0,136,35,171
550,Goa,2010,District Jail,0,0,0,0,0,0,0,0,0,0,0,0,0,0,0
551,Goa,2010,Sub_Jail,33,0,33,187,0,187,0,0,0,0,0,0,220,0,220
552,Goa,2010,Women Jail,0,0,0,0,0,0,0,0,0,0,0,0,0,0,0
553,Goa,2010,Borstal School,0,0,0,0,0,0,0,0,0,0,0,0,0,0,0
554,Goa,2010,Open Jail,0,0,0,0,0,0,0,0,0,0,0,0,0,0,0
555,Goa,2010,Special Jail,0,0,0,0,0,0,0,0,0,0,0,0,0,0,0
556,Goa,2010,Others,0,0,0,65,0,65,0,0,0,0,0,0,65,0,65
557,Goa,2010,Total,169,8,177,252,27,279,0,0,0,0,0,0,421,35,456
558,Goa,2011,Central Jail,118,0,118,3,0,3,0,0,0,0,0,0,121,0,121
559,Goa,2011,District Jail,0,0,0,0,0,0,0,0,0,0,0,0,0,0,0
560,Goa,2011,Sub_Jail,20,6,26,254,28,282,0,0,0,0,0,0,274,34,308
561,Goa,2011,Women Jail,0,0,0,0,0,0,0,0,0,0,0,0,0,0,0
562,Goa,2011,Borstal School,0,0,0,0,0,0,0,0,0,0,0,0,0,0,0
563,Goa,2011,Open Jail,0,0,0,0,0,0,0,0,0,0,0,0,0,0,0
564,Goa,2011,Special Jail,0,0,0,0,0,0,0,0,0,0,0,0,0,0,0
565,Goa,2011,Others,0,0,0,60,0,60,0,0,0,0,0,0,60,0,60
566,Goa,2011,Total,138,6,144,317,28,345,0,0,0,0,0,0,455,34,489
567,Goa,2012,Central Jail,112,0,112,3,0,3,0,0,0,0,0,0,115,0,115
568,Goa,2012,District Jail,0,0,0,0,0,0,0,0,0,0,0,0,0,0,0
569,Goa,2012,Sub_Jail,20,4,24,247,24,271,0,0,0,0,0,0,267,28,295
570,Goa,2012,Women Jail,0,0,0,0,0,0,0,0,0,0,0,0,0,0,0
571,Goa,2012,Borstal School,0,0,0,0,0,0,0,0,0,0,0,0,0,0,0
572,Goa,2012,Open Jail,0,0,0,0,0,0,0,0,0,0,0,0,0,0,0
573,Goa,2012,Special Jail,0,0,0,0,0,0,0,0,0,0,0,0,0,0,0
574,Goa,2012,Others,0,0,0,62,0,62,0,0,0,0,0,0,62,0,62
575,Goa,2012,Total,132,4,136,312,24,336,0,0,0,0,0,0,444,28,472
576,Gujarat,2001,Central Jail,2313,58,2371,1355,32,1387,107,30,137,0,0,0,3775,120,3895
577,Gujarat,2001,District Jail,385,0,385,2350,66,2416,213,0,213,0,0,0,2948,66,3014
578,Gujarat,2001,Sub_Jail,68,0,68,1641,40,1681,20,0,20,0,0,0,1729,40,1769
579,Gujarat,2001,Women Jail,0,0,0,0,0,0,0,0,0,0,0,0,0,0,0
580,Gujarat,2001,Borstal School,0,0,0,0,0,0,0,0,0,0,0,0,0,0,0
581,Gujarat,2001,Open Jail,82,0,82,0,0,0,0,0,0,0,0,0,82,0,82
582,Gujarat,2001,Special Jail,10,0,10,72,1,73,80,0,80,0,0,0,162,1,163
583,Gujarat,2001,Others,0,0,0,0,0,0,0,0,0,0,0,0,0,0,0
584,Gujarat,2001,Total,2858,58,2916,5418,139,5557,420,30,450,0,0,0,8696,227,8923
585,Gujarat,2002,Central Jail,2585,92,2677,1589,46,1635,61,45,106,0,0,0,4235,183,4418
586,Gujarat,2002,District Jail,413,0,413,2653,84,2737,374,0,374,0,0,0,3440,84,3524
587,Gujarat,2002,Sub_Jail,100,0,100,1876,56,1932,18,0,18,0,0,0,1994,56,2050
588,Gujarat,2002,Women Jail,0,0,0,0,0,0,0,0,0,0,0,0,0,0,0
589,Gujarat,2002,Borstal School,0,0,0,0,0,0,0,0,0,0,0,0,0,0,0
590,Gujarat,2002,Open Jail,86,0,86,0,0,0,0,0,0,0,0,0,86,0,86
591,Gujarat,2002,Special Jail,10,0,10,64,1,65,94,0,94,0,0,0,168,1,169
592,Gujarat,2002,Others,0,0,0,0,0,0,0,0,0,0,0,0,0,0,0
593,Gujarat,2002,Total,3194,92,3286,6182,187,6369,547,45,592,0,0,0,9923,324,10247
594,Gujarat,2003,Central Jail,2720,109,2829,1801,76,1877,66,52,118,0,0,0,4587,237,4824
595,Gujarat,2003,District Jail,399,7,406,2526,103,2629,202,0,202,0,0,0,3127,110,3237
596,Gujarat,2003,Sub_Jail,115,1,116,1729,53,1782,18,0,18,0,0,0,1862,54,1916
597,Gujarat,2003,Women Jail,0,0,0,0,0,0,0,0,0,0,0,0,0,0,0
598,Gujarat,2003,Borstal School,0,0,0,0,0,0,0,0,0,0,0,0,0,0,0
599,Gujarat,2003,Open Jail,66,0,66,0,0,0,0,0,0,0,0,0,66,0,66
600,Gujarat,2003,Special Jail,11,0,11,131,2,133,39,0,39,0,0,0,181,2,183
601,Gujarat,2003,Others,0,0,0,0,0,0,0,0,0,0,0,0,0,0,0
602,Gujarat,2003,Total,3311,117,3428,6187,234,6421,325,52,377,0,0,0,9823,403,10226
603,Gujarat,2004,Central Jail,3083,133,3216,2151,72,2223,70,56,126,0,0,0,5304,261,5565
604,Gujarat,2004,District Jail,415,8,423,2821,124,2945,263,0,263,0,0,0,3499,132,3631
605,Gujarat,2004,Sub_Jail,136,1,137,1771,93,1864,23,0,23,0,0,0,1930,94,2024
606,Gujarat,2004,Women Jail,0,0,0,0,0,0,0,0,0,0,0,0,0,0,0
607,Gujarat,2004,Borstal School,0,0,0,0,0,0,0,0,0,0,0,0,0,0,0
608,Gujarat,2004,Open Jail,93,0,93,0,0,0,0,0,0,0,0,0,93,0,93
609,Gujarat,2004,Special Jail,12,0,12,162,8,170,75,0,75,0,0,0,249,8,257
610,Gujarat,2004,Others,0,0,0,0,0,0,0,0,0,0,0,0,0,0,0
611,Gujarat,2004,Total,3739,142,3881,6905,297,7202,431,56,487,0,0,0,11075,495,11570
612,Gujarat,2005,Central Jail,3574,138,3712,2097,65,2162,70,16,86,0,0,0,5741,219,5960
613,Gujarat,2005,District Jail,519,7,526,2450,107,2557,171,1,172,0,0,0,3140,115,3255
614,Gujarat,2005,Sub_Jail,118,2,120,1494,60,1554,29,0,29,0,0,0,1641,62,1703
615,Gujarat,2005,Women Jail,0,0,0,0,0,0,0,0,0,0,0,0,0,0,0
616,Gujarat,2005,Borstal School,0,0,0,0,0,0,0,0,0,0,0,0,0,0,0
617,Gujarat,2005,Open Jail,77,0,77,0,0,0,0,0,0,0,0,0,77,0,77
618,Gujarat,2005,Special Jail,10,0,10,164,14,178,33,0,33,0,0,0,207,14,221
619,Gujarat,2005,Others,0,0,0,0,0,0,0,0,0,0,0,0,0,0,0
620,Gujarat,2005,Total,4298,147,4445,6205,246,6451,303,17,320,0,0,0,10806,410,11216
621,Gujarat,2006,Central Jail,4027,155,4182,2007,67,2074,36,48,84,0,0,0,6070,270,6340
622,Gujarat,2006,District Jail,613,5,618,2451,131,2582,216,1,217,0,0,0,3280,137,3417
623,Gujarat,2006,Sub_Jail,143,0,143,1501,81,1582,40,0,40,0,0,0,1684,81,1765
624,Gujarat,2006,Women Jail,0,0,0,0,0,0,0,0,0,0,0,0,0,0,0
625,Gujarat,2006,Borstal School,0,0,0,0,0,0,0,0,0,0,0,0,0,0,0
626,Gujarat,2006,Open Jail,75,0,75,0,0,0,0,0,0,0,0,0,75,0,75
627,Gujarat,2006,Special Jail,10,0,10,139,10,149,37,0,37,0,0,0,186,10,196
628,Gujarat,2006,Others,0,0,0,0,0,0,0,0,0,0,0,0,0,0,0
629,Gujarat,2006,Total,4868,160,5028,6098,289,6387,329,49,378,0,0,0,11295,498,11793
630,Gujarat,2007,Central Jail,4097,165,4262,1687,74,1761,38,107,145,0,0,0,5822,346,6168
631,Gujarat,2007,District Jail,582,19,601,2561,162,2723,410,51,461,0,0,0,3553,232,3785
632,Gujarat,2007,Sub_Jail,106,8,114,1187,49,1236,201,17,218,0,0,0,1494,74,1568
633,Gujarat,2007,Women Jail,0,0,0,0,0,0,0,0,0,0,0,0,0,0,0
634,Gujarat,2007,Borstal School,0,0,0,0,0,0,0,0,0,0,0,0,0,0,0
635,Gujarat,2007,Open Jail,68,0,68,0,0,0,0,0,0,0,0,0,68,0,68
636,Gujarat,2007,Special Jail,23,1,24,154,12,166,63,0,63,0,0,0,240,13,253
637,Gujarat,2007,Others,0,0,0,0,0,0,0,0,0,0,0,0,0,0,0
638,Gujarat,2007,Total,4876,193,5069,5589,297,5886,712,175,887,0,0,0,11177,665,11842
639,Gujarat,2008,Central Jail,3985,189,4174,1882,83,1965,6,36,42,0,0,0,5873,308,6181
640,Gujarat,2008,District Jail,557,13,570,3087,136,3223,195,9,204,0,0,0,3839,158,3997
641,Gujarat,2008,Sub_Jail,96,5,101,1536,68,1604,105,1,106,0,0,0,1737,74,1811
642,Gujarat,2008,Women Jail,0,0,0,0,0,0,0,0,0,0,0,0,0,0,0
643,Gujarat,2008,Borstal School,0,0,0,0,0,0,0,0,0,0,0,0,0,0,0
644,Gujarat,2008,Open Jail,62,0,62,0,0,0,0,0,0,0,0,0,62,0,62
645,Gujarat,2008,Special Jail,19,1,20,175,4,179,29,0,29,0,0,0,223,5,228
646,Gujarat,2008,Others,0,0,0,0,0,0,0,0,0,0,0,0,0,0,0
647,Gujarat,2008,Total,4719,208,4927,6680,291,6971,335,46,381,0,0,0,11734,545,12279
648,Gujarat,2009,Central Jail,3402,169,3571,2044,109,2153,7,38,45,0,0,0,5453,316,5769
649,Gujarat,2009,District Jail,590,11,601,3031,149,3180,129,16,145,0,0,0,3750,176,3926
650,Gujarat,2009,Sub_Jail,92,4,96,1414,64,1478,121,5,126,0,0,0,1627,73,1700
651,Gujarat,2009,Women Jail,0,0,0,0,0,0,0,0,0,0,0,0,0,0,0
652,Gujarat,2009,Borstal School,0,0,0,0,0,0,0,0,0,0,0,0,0,0,0
653,Gujarat,2009,Open Jail,69,0,69,0,0,0,0,0,0,0,0,0,69,0,69
654,Gujarat,2009,Special Jail,43,0,43,376,19,395,40,0,40,0,0,0,459,19,478
655,Gujarat,2009,Others,0,0,0,0,0,0,0,0,0,0,0,0,0,0,0
656,Gujarat,2009,Total,4196,184,4380,6865,341,7206,297,59,356,0,0,0,11358,584,11942
657,Gujarat,2010,Central Jail,3365,186,3551,2101,91,2192,12,27,39,0,0,0,5478,304,5782
658,Gujarat,2010,District Jail,626,5,631,2663,157,2820,96,7,103,0,0,0,3385,169,3554
659,Gujarat,2010,Sub_Jail,73,0,73,1384,72,1456,61,0,61,0,0,0,1518,72,1590
660,Gujarat,2010,Women Jail,0,0,0,0,0,0,0,0,0,0,0,0,0,0,0
661,Gujarat,2010,Borstal School,0,0,0,0,0,0,0,0,0,0,0,0,0,0,0
662,Gujarat,2010,Open Jail,74,0,74,0,0,0,0,0,0,0,0,0,74,0,74
663,Gujarat,2010,Special Jail,45,0,45,411,31,442,41,0,41,0,0,0,497,31,528
664,Gujarat,2010,Others,0,0,0,0,0,0,0,0,0,0,0,0,0,0,0
665,Gujarat,2010,Total,4183,191,4374,6559,351,6910,210,34,244,0,0,0,10952,576,11528
666,Gujarat,2011,Central Jail,3436,173,3609,1874,60,1934,26,11,37,0,0,0,5336,244,5580
667,Gujarat,2011,District Jail,681,3,684,2765,148,2913,169,28,197,0,0,0,3615,179,3794
668,Gujarat,2011,Sub_Jail,94,0,94,1266,94,1360,102,4,106,0,0,0,1462,98,1560
669,Gujarat,2011,Women Jail,0,0,0,0,0,0,0,0,0,0,0,0,0,0,0
670,Gujarat,2011,Borstal School,0,0,0,0,0,0,0,0,0,0,0,0,0,0,0
671,Gujarat,2011,Open Jail,74,0,74,0,0,0,0,0,0,0,0,0,74,0,74
672,Gujarat,2011,Special Jail,43,0,43,463,26,489,58,3,61,0,0,0,564,29,593
673,Gujarat,2011,Others,0,0,0,0,0,0,0,0,0,0,0,0,0,0,0
674,Gujarat,2011,Total,4328,176,4504,6368,328,6696,355,46,401,0,0,0,11051,550,11601
675,Gujarat,2012,Central Jail,3775,94,3869,3046,118,3164,284,23,307,0,0,0,7105,235,7340
676,Gujarat,2012,District Jail,254,6,260,1737,85,1822,105,14,119,0,0,0,2096,105,2201
677,Gujarat,2012,Sub_Jail,112,0,112,1087,83,1170,25,0,25,0,0,0,1224,83,1307
678,Gujarat,2012,Women Jail,0,84,84,0,14,14,0,11,11,0,0,0,0,109,109
679,Gujarat,2012,Borstal School,0,0,0,0,0,0,0,0,0,0,0,0,0,0,0
680,Gujarat,2012,Open Jail,72,0,72,0,0,0,0,0,0,0,0,0,72,0,72
681,Gujarat,2012,Special Jail,56,0,56,416,27,443,54,3,57,0,0,0,526,30,556
682,Gujarat,2012,Others,0,0,0,0,0,0,0,0,0,0,0,0,0,0,0
683,Gujarat,2012,Total,4269,184,4453,6286,327,6613,468,51,519,0,0,0,11023,562,11585
684,Haryana,2001,Central Jail,1221,8,1229,2407,59,2466,0,0,0,22,0,22,3650,67,3717
685,Haryana,2001,District Jail,1731,3,1734,4963,185,5148,0,0,0,21,0,21,6715,188,6903
686,Haryana,2001,Sub_Jail,7,0,7,426,0,426,0,0,0,1,0,1,434,0,434
687,Haryana,2001,Women Jail,0,0,0,0,0,0,0,0,0,0,0,0,0,0,0
688,Haryana,2001,Borstal School,25,97,122,93,79,172,0,0,0,0,0,0,118,176,294
689,Haryana,2001,Open Jail,0,0,0,0,0,0,0,0,0,0,0,0,0,0,0
690,Haryana,2001,Special Jail,0,0,0,0,0,0,0,0,0,0,0,0,0,0,0
691,Haryana,2001,Others,0,0,0,0,0,0,0,0,0,0,0,0,0,0,0
692,Haryana,2001,Total,2984,108,3092,7889,323,8212,0,0,0,44,0,44,10917,431,11348
693,Haryana,2002,Central Jail,1382,17,1399,2200,82,2282,0,0,0,7,0,7,3589,99,3688
694,Haryana,2002,District Jail,2093,5,2098,4688,173,4861,0,0,0,0,0,0,6781,178,6959
695,Haryana,2002,Sub_Jail,5,0,5,435,0,435,0,0,0,1,0,1,441,0,441
696,Haryana,2002,Women Jail,0,0,0,0,0,0,0,0,0,0,0,0,0,0,0
697,Haryana,2002,Borstal School,23,108,131,73,66,139,0,0,0,0,0,0,96,174,270
698,Haryana,2002,Open Jail,0,0,0,0,0,0,0,0,0,0,0,0,0,0,0
699,Haryana,2002,Special Jail,0,0,0,0,0,0,0,0,0,0,0,0,0,0,0
700,Haryana,2002,Others,0,0,0,0,0,0,0,0,0,0,0,0,0,0,0
701,Haryana,2002,Total,3503,130,3633,7396,321,7717,0,0,0,8,0,8,10907,451,11358
702,Haryana,2003,Central Jail,1564,32,1596,1979,88,2067,0,0,0,76,0,76,3619,120,3739
703,Haryana,2003,District Jail,2696,32,2728,4837,190,5027,0,0,0,63,0,63,7596,222,7818
704,Haryana,2003,Sub_Jail,0,0,0,294,0,294,0,0,0,13,0,13,307,0,307
705,Haryana,2003,Women Jail,0,0,0,0,0,0,0,0,0,0,0,0,0,0,0
706,Haryana,2003,Borstal School,16,103,119,57,59,116,0,0,0,0,0,0,73,162,235
707,Haryana,2003,Open Jail,0,0,0,0,0,0,0,0,0,0,0,0,0,0,0
708,Haryana,2003,Special Jail,0,0,0,0,0,0,0,0,0,0,0,0,0,0,0
709,Haryana,2003,Others,0,0,0,0,0,0,0,0,0,0,0,0,0,0,0
710,Haryana,2003,Total,4276,167,4443,7167,337,7504,0,0,0,152,0,152,11595,504,12099
711,Haryana,2004,Central Jail,1540,29,1569,1947,67,2014,0,0,0,3,0,3,3490,96,3586
712,Haryana,2004,District Jail,2858,65,2923,4776,193,4969,0,0,0,10,0,10,7644,258,7902
713,Haryana,2004,Sub_Jail,0,0,0,316,0,316,0,0,0,0,0,0,316,0,316
714,Haryana,2004,Women Jail,0,0,0,0,0,0,0,0,0,0,0,0,0,0,0
715,Haryana,2004,Borstal School,13,96,109,51,46,97,0,0,0,0,0,0,64,142,206
716,Haryana,2004,Open Jail,0,0,0,0,0,0,0,0,0,0,0,0,0,0,0
717,Haryana,2004,Special Jail,0,0,0,0,0,0,0,0,0,0,0,0,0,0,0
718,Haryana,2004,Others,0,0,0,0,0,0,0,0,0,0,0,0,0,0,0
719,Haryana,2004,Total,4411,190,4601,7090,306,7396,0,0,0,13,0,13,11514,496,12010
720,Haryana,2005,Central Jail,1249,24,1273,1484,43,1527,0,0,0,17,1,18,2750,68,2818
721,Haryana,2005,District Jail,3346,104,3450,5546,207,5753,0,0,0,16,0,16,8908,311,9219
722,Haryana,2005,Sub_Jail,0,0,0,300,0,300,0,0,0,3,0,3,303,0,303
723,Haryana,2005,Women Jail,0,0,0,0,0,0,0,0,0,0,0,0,0,0,0
724,Haryana,2005,Borstal School,10,60,70,61,76,137,0,0,0,0,0,0,71,136,207
725,Haryana,2005,Open Jail,0,0,0,0,0,0,0,0,0,0,0,0,0,0,0
726,Haryana,2005,Special Jail,0,0,0,0,0,0,0,0,0,0,0,0,0,0,0
727,Haryana,2005,Others,0,0,0,0,0,0,0,0,0,0,0,0,0,0,0
728,Haryana,2005,Total,4605,188,4793,7391,326,7717,0,0,0,36,1,37,12032,515,12547
729,Haryana,2006,Central Jail,1166,28,1194,1411,34,1445,0,0,0,3,0,3,2580,62,2642
730,Haryana,2006,District Jail,3616,104,3720,5618,231,5849,0,0,0,8,0,8,9242,335,9577
731,Haryana,2006,Sub_Jail,0,0,0,253,0,253,0,0,0,2,0,2,255,0,255
732,Haryana,2006,Women Jail,0,0,0,0,0,0,0,0,0,0,0,0,0,0,0
733,Haryana,2006,Borstal School,6,68,74,71,68,139,0,0,0,0,0,0,77,136,213
734,Haryana,2006,Open Jail,0,0,0,0,0,0,0,0,0,0,0,0,0,0,0
735,Haryana,2006,Special Jail,0,0,0,0,0,0,0,0,0,0,0,0,0,0,0
736,Haryana,2006,Others,0,0,0,0,0,0,0,0,0,0,0,0,0,0,0
737,Haryana,2006,Total,4788,200,4988,7353,333,7686,0,0,0,13,0,13,12154,533,12687
738,Haryana,2007,Central Jail,1134,25,1159,1507,28,1535,0,0,0,0,0,0,2641,53,2694
739,Haryana,2007,District Jail,3632,108,3740,5978,281,6259,0,0,0,0,0,0,9610,389,9999
740,Haryana,2007,Sub_Jail,0,0,0,224,0,224,0,0,0,0,0,0,224,0,224
741,Haryana,2007,Women Jail,0,0,0,0,0,0,0,0,0,0,0,0,0,0,0
742,Haryana,2007,Borstal School,9,68,77,48,51,99,0,0,0,0,0,0,57,119,176
743,Haryana,2007,Open Jail,0,0,0,0,0,0,0,0,0,0,0,0,0,0,0
744,Haryana,2007,Special Jail,0,0,0,0,0,0,0,0,0,0,0,0,0,0,0
745,Haryana,2007,Others,0,0,0,0,0,0,0,0,0,0,0,0,0,0,0
746,Haryana,2007,Total,4775,201,4976,7757,360,8117,0,0,0,0,0,0,12532,561,13093
747,Haryana,2008,Central Jail,1327,34,1361,1503,58,1561,0,0,0,0,0,0,2830,92,2922
748,Haryana,2008,District Jail,3792,140,3932,6448,275,6723,0,0,0,0,0,0,10240,415,10655
749,Haryana,2008,Sub_Jail,0,0,0,251,0,251,0,0,0,0,0,0,251,0,251
750,Haryana,2008,Women Jail,0,0,0,0,0,0,0,0,0,0,0,0,0,0,0
751,Haryana,2008,Borstal School,13,81,94,58,69,127,0,0,0,0,0,0,71,150,221
752,Haryana,2008,Open Jail,0,0,0,0,0,0,0,0,0,0,0,0,0,0,0
753,Haryana,2008,Special Jail,0,0,0,0,0,0,0,0,0,0,0,0,0,0,0
754,Haryana,2008,Others,0,0,0,0,0,0,0,0,0,0,0,0,0,0,0
755,Haryana,2008,Total,5132,255,5387,8260,402,8662,0,0,0,0,0,0,13392,657,14049
756,Haryana,2009,Central Jail,1198,7,1205,1350,34,1384,0,0,0,0,0,0,2548,41,2589
757,Haryana,2009,District Jail,4318,143,4461,6162,258,6420,0,0,0,0,0,0,10480,401,10881
758,Haryana,2009,Sub_Jail,0,0,0,111,0,111,0,0,0,4,0,4,115,0,115
759,Haryana,2009,Women Jail,0,0,0,0,0,0,0,0,0,0,0,0,0,0,0
760,Haryana,2009,Borstal School,12,114,126,64,62,126,0,0,0,0,0,0,76,176,252
761,Haryana,2009,Open Jail,0,0,0,0,0,0,0,0,0,0,0,0,0,0,0
762,Haryana,2009,Special Jail,0,0,0,0,0,0,0,0,0,0,0,0,0,0,0
763,Haryana,2009,Others,0,0,0,0,0,0,0,0,0,0,0,0,0,0,0
764,Haryana,2009,Total,5528,264,5792,7687,354,8041,0,0,0,4,0,4,13219,618,13837
765,Haryana,2010,Central Jail,1224,21,1245,1417,34,1451,0,0,0,0,0,0,2641,55,2696
766,Haryana,2010,District Jail,4733,138,4871,6183,230,6413,0,0,0,0,0,0,10916,368,11284
767,Haryana,2010,Sub_Jail,0,0,0,0,0,0,0,0,0,0,0,0,0,0,0
768,Haryana,2010,Women Jail,0,0,0,0,0,0,0,0,0,0,0,0,0,0,0
769,Haryana,2010,Borstal School,9,86,95,58,86,144,0,0,0,0,0,0,67,172,239
770,Haryana,2010,Open Jail,0,0,0,0,0,0,0,0,0,0,0,0,0,0,0
771,Haryana,2010,Special Jail,0,0,0,0,0,0,0,0,0,0,0,0,0,0,0
772,Haryana,2010,Others,0,0,0,0,0,0,0,0,0,0,0,0,0,0,0
773,Haryana,2010,Total,5966,245,6211,7658,350,8008,0,0,0,0,0,0,13624,595,14219
774,Haryana,2011,Central Jail,1098,23,1121,1456,34,1490,0,0,0,0,0,0,2554,57,2611
775,Haryana,2011,District Jail,5142,180,5322,6592,272,6864,0,0,0,1,0,1,11735,452,12187
776,Haryana,2011,Sub_Jail,0,0,0,0,0,0,0,0,0,0,0,0,0,0,0
777,Haryana,2011,Women Jail,0,0,0,0,0,0,0,0,0,0,0,0,0,0,0
778,Haryana,2011,Borstal School,4,82,86,70,79,149,0,0,0,0,0,0,74,161,235
779,Haryana,2011,Open Jail,0,0,0,0,0,0,0,0,0,0,0,0,0,0,0
780,Haryana,2011,Special Jail,0,0,0,0,0,0,0,0,0,0,0,0,0,0,0
781,Haryana,2011,Others,0,0,0,0,0,0,0,0,0,0,0,0,0,0,0
782,Haryana,2011,Total,6244,285,6529,8118,385,8503,0,0,0,1,0,1,14363,670,15033
783,Haryana,2012,Central Jail,1193,22,1215,1686,71,1757,0,0,0,0,0,0,2879,93,2972
784,Haryana,2012,District Jail,5209,180,5389,7999,287,8286,0,0,0,0,0,0,13208,467,13675
785,Haryana,2012,Sub_Jail,0,0,0,0,0,0,0,0,0,0,0,0,0,0,0
786,Haryana,2012,Women Jail,0,0,0,0,0,0,0,0,0,0,0,0,0,0,0
787,Haryana,2012,Borstal School,9,88,97,106,102,208,0,0,0,0,0,0,115,190,305
788,Haryana,2012,Open Jail,0,0,0,0,0,0,0,0,0,0,0,0,0,0,0
789,Haryana,2012,Special Jail,0,0,0,0,0,0,0,0,0,0,0,0,0,0,0
790,Haryana,2012,Others,0,0,0,0,0,0,0,0,0,0,0,0,0,0,0
791,Haryana,2012,Total,6411,290,6701,9791,460,10251,0,0,0,0,0,0,16202,750,16952
792,Himachal Pradesh,2001,Central Jail,283,11,294,104,2,106,0,0,0,0,0,0,387,13,400
793,Himachal Pradesh,2001,District Jail,29,0,29,127,5,132,0,0,0,0,0,0,156,5,161
794,Himachal Pradesh,2001,Sub_Jail,24,0,24,266,8,274,0,0,0,0,0,0,290,8,298
795,Himachal Pradesh,2001,Women Jail,0,0,0,0,0,0,0,0,0,0,0,0,0,0,0
796,Himachal Pradesh,2001,Borstal School,7,0,7,0,0,0,0,0,0,0,0,0,7,0,7
797,Himachal Pradesh,2001,Open Jail,41,0,41,0,0,0,0,0,0,0,0,0,41,0,41
798,Himachal Pradesh,2001,Special Jail,0,0,0,0,0,0,0,0,0,0,0,0,0,0,0
799,Himachal Pradesh,2001,Others,0,0,0,0,0,0,0,0,0,0,0,0,0,0,0
800,Himachal Pradesh,2001,Total,384,11,395,497,15,512,0,0,0,0,0,0,881,26,907
801,Himachal Pradesh,2002,Central Jail,333,6,339,66,2,68,0,0,0,0,0,0,399,8,407
802,Himachal Pradesh,2002,District Jail,22,1,23,126,1,127,0,0,0,0,0,0,148,2,150
803,Himachal Pradesh,2002,Sub_Jail,11,0,11,266,17,283,0,0,0,0,0,0,277,17,294
804,Himachal Pradesh,2002,Women Jail,0,0,0,0,0,0,0,0,0,0,0,0,0,0,0
805,Himachal Pradesh,2002,Borstal School,13,0,13,0,0,0,0,0,0,0,0,0,13,0,13
806,Himachal Pradesh,2002,Open Jail,33,0,33,0,0,0,0,0,0,0,0,0,33,0,33
807,Himachal Pradesh,2002,Special Jail,0,0,0,0,0,0,0,0,0,0,0,0,0,0,0
808,Himachal Pradesh,2002,Others,0,0,0,0,0,0,0,0,0,0,0,0,0,0,0
809,Himachal Pradesh,2002,Total,412,7,419,458,20,478,0,0,0,0,0,0,870,27,897
810,Himachal Pradesh,2003,Central Jail,380,10,390,69,0,69,0,0,0,0,0,0,449,10,459
811,Himachal Pradesh,2003,District Jail,36,1,37,159,5,164,0,0,0,0,0,0,195,6,201
812,Himachal Pradesh,2003,Sub_Jail,14,1,15,255,14,269,0,0,0,0,0,0,269,15,284
813,Himachal Pradesh,2003,Women Jail,0,0,0,0,0,0,0,0,0,0,0,0,0,0,0
814,Himachal Pradesh,2003,Borstal School,4,0,4,0,0,0,0,0,0,0,0,0,4,0,4
815,Himachal Pradesh,2003,Open Jail,30,0,30,0,0,0,0,0,0,0,0,0,30,0,30
816,Himachal Pradesh,2003,Special Jail,0,0,0,0,0,0,0,0,0,0,0,0,0,0,0
817,Himachal Pradesh,2003,Others,0,0,0,0,0,0,0,0,0,0,0,0,0,0,0
818,Himachal Pradesh,2003,Total,464,12,476,483,19,502,0,0,0,0,0,0,947,31,978
819,Himachal Pradesh,2004,Central Jail,426,16,442,111,1,112,0,0,0,0,0,0,537,17,554
820,Himachal Pradesh,2004,District Jail,65,1,66,125,5,130,0,0,0,0,0,0,190,6,196
821,Himachal Pradesh,2004,Sub_Jail,8,0,8,232,13,245,0,0,0,0,0,0,240,13,253
822,Himachal Pradesh,2004,Women Jail,0,0,0,0,0,0,0,0,0,0,0,0,0,0,0
823,Himachal Pradesh,2004,Borstal School,5,0,5,0,0,0,0,0,0,0,0,0,5,0,5
824,Himachal Pradesh,2004,Open Jail,36,0,36,0,0,0,0,0,0,0,0,0,36,0,36
825,Himachal Pradesh,2004,Special Jail,0,0,0,0,0,0,0,0,0,0,0,0,0,0,0
826,Himachal Pradesh,2004,Others,0,0,0,0,0,0,0,0,0,0,0,0,0,0,0
827,Himachal Pradesh,2004,Total,540,17,557,468,19,487,0,0,0,0,0,0,1008,36,1044
828,Himachal Pradesh,2005,Central Jail,450,14,464,126,1,127,0,0,0,0,0,0,576,15,591
829,Himachal Pradesh,2005,District Jail,89,2,91,125,9,134,0,0,0,0,0,0,214,11,225
830,Himachal Pradesh,2005,Sub_Jail,21,2,23,269,6,275,0,0,0,0,0,0,290,8,298
831,Himachal Pradesh,2005,Women Jail,0,0,0,0,0,0,0,0,0,0,0,0,0,0,0
832,Himachal Pradesh,2005,Borstal School,20,0,20,0,0,0,0,0,0,0,0,0,20,0,20
833,Himachal Pradesh,2005,Open Jail,34,0,34,0,0,0,0,0,0,0,0,0,34,0,34
834,Himachal Pradesh,2005,Special Jail,0,0,0,0,0,0,0,0,0,0,0,0,0,0,0
835,Himachal Pradesh,2005,Others,0,0,0,0,0,0,0,0,0,0,0,0,0,0,0
836,Himachal Pradesh,2005,Total,614,18,632,520,16,536,0,0,0,0,0,0,1134,34,1168
837,Himachal Pradesh,2006,Central Jail,543,17,560,161,2,163,0,0,0,0,0,0,704,19,723
838,Himachal Pradesh,2006,District Jail,122,6,128,135,8,143,0,0,0,0,0,0,257,14,271
839,Himachal Pradesh,2006,Sub_Jail,20,1,21,255,11,266,0,0,0,0,0,0,275,12,287
840,Himachal Pradesh,2006,Women Jail,0,0,0,0,0,0,0,0,0,0,0,0,0,0,0
841,Himachal Pradesh,2006,Borstal School,17,0,17,0,0,0,0,0,0,0,0,0,17,0,17
842,Himachal Pradesh,2006,Open Jail,38,0,38,0,0,0,0,0,0,0,0,0,38,0,38
843,Himachal Pradesh,2006,Special Jail,0,0,0,0,0,0,0,0,0,0,0,0,0,0,0
844,Himachal Pradesh,2006,Others,0,0,0,0,0,0,0,0,0,0,0,0,0,0,0
845,Himachal Pradesh,2006,Total,740,24,764,551,21,572,0,0,0,0,0,0,1291,45,1336
846,Himachal Pradesh,2007,Central Jail,608,26,634,142,5,147,0,0,0,0,0,0,750,31,781
847,Himachal Pradesh,2007,District Jail,150,8,158,129,8,137,0,0,0,0,0,0,279,16,295
848,Himachal Pradesh,2007,Sub_Jail,18,3,21,265,11,276,0,0,0,0,0,0,283,14,297
849,Himachal Pradesh,2007,Women Jail,0,0,0,0,0,0,0,0,0,0,0,0,0,0,0
850,Himachal Pradesh,2007,Borstal School,13,0,13,0,0,0,0,0,0,0,0,0,13,0,13
851,Himachal Pradesh,2007,Open Jail,49,0,49,0,0,0,0,0,0,0,0,0,49,0,49
852,Himachal Pradesh,2007,Special Jail,0,0,0,0,0,0,0,0,0,0,0,0,0,0,0
853,Himachal Pradesh,2007,Others,0,0,0,0,0,0,0,0,0,0,0,0,0,0,0
854,Himachal Pradesh,2007,Total,838,37,875,536,24,560,0,0,0,0,0,0,1374,61,1435
855,Himachal Pradesh,2008,Central Jail,592,22,614,98,6,104,0,0,0,0,0,0,690,28,718
856,Himachal Pradesh,2008,District Jail,179,6,185,129,11,140,0,0,0,0,0,0,308,17,325
857,Himachal Pradesh,2008,Sub_Jail,27,4,31,325,9,334,0,0,0,0,0,0,352,13,365
858,Himachal Pradesh,2008,Women Jail,0,0,0,0,0,0,0,0,0,0,0,0,0,0,0
859,Himachal Pradesh,2008,Borstal School,10,0,10,0,0,0,0,0,0,0,0,0,10,0,10
860,Himachal Pradesh,2008,Open Jail,50,0,50,0,0,0,0,0,0,0,0,0,50,0,50
861,Himachal Pradesh,2008,Special Jail,0,0,0,0,0,0,0,0,0,0,0,0,0,0,0
862,Himachal Pradesh,2008,Others,0,0,0,0,0,0,0,0,0,0,0,0,0,0,0
863,Himachal Pradesh,2008,Total,858,32,890,552,26,578,0,0,0,0,0,0,1410,58,1468
864,Himachal Pradesh,2009,Central Jail,555,25,580,143,3,146,0,0,0,0,0,0,698,28,726
865,Himachal Pradesh,2009,District Jail,163,7,170,184,6,190,0,0,0,0,0,0,347,13,360
866,Himachal Pradesh,2009,Sub_Jail,24,3,27,368,8,376,0,0,0,0,0,0,392,11,403
867,Himachal Pradesh,2009,Women Jail,0,0,0,0,0,0,0,0,0,0,0,0,0,0,0
868,Himachal Pradesh,2009,Borstal School,10,0,10,0,0,0,0,0,0,0,0,0,10,0,10
869,Himachal Pradesh,2009,Open Jail,55,0,55,0,0,0,0,0,0,0,0,0,55,0,55
870,Himachal Pradesh,2009,Special Jail,0,0,0,0,0,0,0,0,0,0,0,0,0,0,0
871,Himachal Pradesh,2009,Others,0,0,0,0,0,0,0,0,0,0,0,0,0,0,0
872,Himachal Pradesh,2009,Total,807,35,842,695,17,712,0,0,0,0,0,0,1502,52,1554
873,Himachal Pradesh,2010,Central Jail,644,22,666,163,5,168,0,0,0,0,0,0,807,27,834
874,Himachal Pradesh,2010,District Jail,202,4,206,124,6,130,0,0,0,0,0,0,326,10,336
875,Himachal Pradesh,2010,Sub_Jail,27,1,28,313,12,325,0,0,0,0,0,0,340,13,353
876,Himachal Pradesh,2010,Women Jail,0,0,0,0,0,0,0,0,0,0,0,0,0,0,0
877,Himachal Pradesh,2010,Borstal School,9,0,9,0,0,0,0,0,0,0,0,0,9,0,9
878,Himachal Pradesh,2010,Open Jail,53,0,53,0,0,0,0,0,0,0,0,0,53,0,53
879,Himachal Pradesh,2010,Special Jail,0,0,0,0,0,0,0,0,0,0,0,0,0,0,0
880,Himachal Pradesh,2010,Others,0,0,0,0,0,0,0,0,0,0,0,0,0,0,0
881,Himachal Pradesh,2010,Total,935,27,962,600,23,623,0,0,0,0,0,0,1535,50,1585
882,Himachal Pradesh,2011,Central Jail,556,16,572,170,5,175,0,0,0,0,0,0,726,21,747
883,Himachal Pradesh,2011,District Jail,196,5,201,107,12,119,0,0,0,0,0,0,303,17,320
884,Himachal Pradesh,2011,Sub_Jail,94,8,102,355,16,371,0,0,0,0,0,0,449,24,473
885,Himachal Pradesh,2011,Women Jail,0,0,0,0,0,0,0,0,0,0,0,0,0,0,0
886,Himachal Pradesh,2011,Borstal School,4,0,4,0,0,0,0,0,0,0,0,0,4,0,4
887,Himachal Pradesh,2011,Open Jail,63,0,63,0,0,0,0,0,0,0,0,0,63,0,63
888,Himachal Pradesh,2011,Special Jail,0,0,0,0,0,0,0,0,0,0,0,0,0,0,0
889,Himachal Pradesh,2011,Others,0,0,0,0,0,0,0,0,0,0,0,0,0,0,0
890,Himachal Pradesh,2011,Total,913,29,942,632,33,665,0,0,0,0,0,0,1545,62,1607
891,Himachal Pradesh,2012,Central Jail,565,20,585,152,4,156,0,0,0,0,0,0,717,24,741
892,Himachal Pradesh,2012,District Jail,181,6,187,147,11,158,0,0,0,0,0,0,328,17,345
893,Himachal Pradesh,2012,Sub_Jail,96,10,106,428,22,450,0,0,0,0,0,0,524,32,556
894,Himachal Pradesh,2012,Women Jail,0,0,0,0,0,0,0,0,0,0,0,0,0,0,0
895,Himachal Pradesh,2012,Borstal School,3,0,3,0,0,0,0,0,0,0,0,0,3,0,3
896,Himachal Pradesh,2012,Open Jail,71,0,71,0,0,0,0,0,0,0,0,0,71,0,71
897,Himachal Pradesh,2012,Special Jail,0,0,0,0,0,0,0,0,0,0,0,0,0,0,0
898,Himachal Pradesh,2012,Others,0,0,0,0,0,0,0,0,0,0,0,0,0,0,0
899,Himachal Pradesh,2012,Total,916,36,952,727,37,764,0,0,0,0,0,0,1643,73,1716
900,Jammu & Kashmir,2001,Central Jail,29,0,29,332,6,338,177,0,177,1,0,1,539,6,545
901,Jammu & Kashmir,2001,District Jail,82,5,87,672,27,699,220,2,222,2,0,2,976,34,1010
902,Jammu & Kashmir,2001,Sub_Jail,7,0,7,68,0,68,17,0,17,0,0,0,92,0,92
903,Jammu & Kashmir,2001,Women Jail,0,0,0,0,0,0,0,0,0,0,0,0,0,0,0
904,Jammu & Kashmir,2001,Borstal School,0,0,0,0,0,0,0,0,0,0,0,0,0,0,0
905,Jammu & Kashmir,2001,Open Jail,0,0,0,0,0,0,0,0,0,0,0,0,0,0,0
906,Jammu & Kashmir,2001,Special Jail,0,0,0,0,0,0,0,0,0,0,0,0,0,0,0
907,Jammu & Kashmir,2001,Others,0,0,0,0,0,0,0,0,0,0,0,0,0,0,0
908,Jammu & Kashmir,2001,Total,118,5,123,1072,33,1105,414,2,416,3,0,3,1607,40,1647
909,Jammu & Kashmir,2002,Central Jail,40,0,40,386,12,398,262,0,262,1,0,1,689,12,701
910,Jammu & Kashmir,2002,District Jail,80,3,83,727,34,761,171,1,172,0,0,0,978,38,1016
911,Jammu & Kashmir,2002,Sub_Jail,6,0,6,70,0,70,10,0,10,0,0,0,86,0,86
912,Jammu & Kashmir,2002,Women Jail,0,0,0,0,0,0,0,0,0,0,0,0,0,0,0
913,Jammu & Kashmir,2002,Borstal School,0,0,0,0,0,0,0,0,0,0,0,0,0,0,0
914,Jammu & Kashmir,2002,Open Jail,0,0,0,0,0,0,0,0,0,0,0,0,0,0,0
915,Jammu & Kashmir,2002,Special Jail,0,0,0,0,0,0,0,0,0,0,0,0,0,0,0
916,Jammu & Kashmir,2002,Others,0,0,0,0,0,0,0,0,0,0,0,0,0,0,0
917,Jammu & Kashmir,2002,Total,126,3,129,1183,46,1229,443,1,444,1,0,1,1753,50,1803
918,Jammu & Kashmir,2003,Central Jail,49,0,49,360,11,371,254,0,254,0,0,0,663,11,674
919,Jammu & Kashmir,2003,District Jail,113,1,114,843,53,896,134,0,134,0,0,0,1090,54,1144
920,Jammu & Kashmir,2003,Sub_Jail,5,0,5,63,0,63,9,0,9,0,0,0,77,0,77
921,Jammu & Kashmir,2003,Women Jail,0,0,0,0,0,0,0,0,0,0,0,0,0,0,0
922,Jammu & Kashmir,2003,Borstal School,0,0,0,0,0,0,0,0,0,0,0,0,0,0,0
923,Jammu & Kashmir,2003,Open Jail,0,0,0,0,0,0,0,0,0,0,0,0,0,0,0
924,Jammu & Kashmir,2003,Special Jail,0,0,0,0,0,0,0,0,0,0,0,0,0,0,0
925,Jammu & Kashmir,2003,Others,0,0,0,0,0,0,0,0,0,0,0,0,0,0,0
926,Jammu & Kashmir,2003,Total,167,1,168,1266,64,1330,397,0,397,0,0,0,1830,65,1895
927,Jammu & Kashmir,2004,Central Jail,72,0,72,458,8,466,273,1,274,0,0,0,803,9,812
928,Jammu & Kashmir,2004,District Jail,113,5,118,811,45,856,175,1,176,1,0,1,1100,51,1151
929,Jammu & Kashmir,2004,Sub_Jail,10,0,10,65,0,65,1,0,1,0,0,0,76,0,76
930,Jammu & Kashmir,2004,Women Jail,0,0,0,0,0,0,0,0,0,0,0,0,0,0,0
931,Jammu & Kashmir,2004,Borstal School,0,0,0,0,0,0,0,0,0,0,0,0,0,0,0
932,Jammu & Kashmir,2004,Open Jail,0,0,0,0,0,0,0,0,0,0,0,0,0,0,0
933,Jammu & Kashmir,2004,Special Jail,0,0,0,0,0,0,0,0,0,0,0,0,0,0,0
934,Jammu & Kashmir,2004,Others,0,0,0,0,0,0,0,0,0,0,0,0,0,0,0
935,Jammu & Kashmir,2004,Total,195,5,200,1334,53,1387,449,2,451,1,0,1,1979,60,2039
936,Jammu & Kashmir,2005,Central Jail,87,1,88,516,11,527,255,2,257,0,0,0,858,14,872
937,Jammu & Kashmir,2005,District Jail,117,9,126,893,46,939,116,2,118,0,0,0,1126,57,1183
938,Jammu & Kashmir,2005,Sub_Jail,7,0,7,73,0,73,2,0,2,0,0,0,82,0,82
939,Jammu & Kashmir,2005,Women Jail,0,0,0,0,0,0,0,0,0,0,0,0,0,0,0
940,Jammu & Kashmir,2005,Borstal School,0,0,0,0,0,0,0,0,0,0,0,0,0,0,0
941,Jammu & Kashmir,2005,Open Jail,0,0,0,0,0,0,0,0,0,0,0,0,0,0,0
942,Jammu & Kashmir,2005,Special Jail,0,0,0,0,0,0,0,0,0,0,0,0,0,0,0
943,Jammu & Kashmir,2005,Others,0,0,0,0,0,0,0,0,0,0,0,0,0,0,0
944,Jammu & Kashmir,2005,Total,211,10,221,1482,57,1539,373,4,377,0,0,0,2066,71,2137
945,Jammu & Kashmir,2006,Central Jail,82,0,82,508,13,521,228,0,228,0,0,0,818,13,831
946,Jammu & Kashmir,2006,District Jail,165,9,174,1004,36,1040,139,1,140,3,0,3,1311,46,1357
947,Jammu & Kashmir,2006,Sub_Jail,8,0,8,73,0,73,1,0,1,0,0,0,82,0,82
948,Jammu & Kashmir,2006,Women Jail,0,0,0,0,0,0,0,0,0,0,0,0,0,0,0
949,Jammu & Kashmir,2006,Borstal School,0,0,0,0,0,0,0,0,0,0,0,0,0,0,0
950,Jammu & Kashmir,2006,Open Jail,0,0,0,0,0,0,0,0,0,0,0,0,0,0,0
951,Jammu & Kashmir,2006,Special Jail,0,0,0,0,0,0,0,0,0,0,0,0,0,0,0
952,Jammu & Kashmir,2006,Others,0,0,0,0,0,0,0,0,0,0,0,0,0,0,0
953,Jammu & Kashmir,2006,Total,255,9,264,1585,49,1634,368,1,369,3,0,3,2211,59,2270
954,Jammu & Kashmir,2007,Central Jail,92,0,92,517,8,525,153,2,155,0,0,0,762,10,772
955,Jammu & Kashmir,2007,District Jail,174,7,181,1062,64,1126,118,1,119,0,0,0,1354,72,1426
956,Jammu & Kashmir,2007,Sub_Jail,19,0,19,81,0,81,1,0,1,0,0,0,101,0,101
957,Jammu & Kashmir,2007,Women Jail,0,0,0,0,0,0,0,0,0,0,0,0,0,0,0
958,Jammu & Kashmir,2007,Borstal School,0,0,0,0,0,0,0,0,0,0,0,0,0,0,0
959,Jammu & Kashmir,2007,Open Jail,0,0,0,0,0,0,0,0,0,0,0,0,0,0,0
960,Jammu & Kashmir,2007,Special Jail,0,0,0,0,0,0,0,0,0,0,0,0,0,0,0
961,Jammu & Kashmir,2007,Others,0,0,0,0,0,0,0,0,0,0,0,0,0,0,0
962,Jammu & Kashmir,2007,Total,285,7,292,1660,72,1732,272,3,275,0,0,0,2217,82,2299
963,Jammu & Kashmir,2008,Central Jail,110,0,110,464,8,472,144,1,145,0,0,0,718,9,727
964,Jammu & Kashmir,2008,District Jail,209,9,218,1077,67,1144,120,0,120,0,0,0,1406,76,1482
965,Jammu & Kashmir,2008,Sub_Jail,10,0,10,90,0,90,1,0,1,0,0,0,101,0,101
966,Jammu & Kashmir,2008,Women Jail,0,0,0,0,0,0,0,0,0,0,0,0,0,0,0
967,Jammu & Kashmir,2008,Borstal School,0,0,0,0,0,0,0,0,0,0,0,0,0,0,0
968,Jammu & Kashmir,2008,Open Jail,0,0,0,0,0,0,0,0,0,0,0,0,0,0,0
969,Jammu & Kashmir,2008,Special Jail,0,0,0,0,0,0,0,0,0,0,0,0,0,0,0
970,Jammu & Kashmir,2008,Others,0,0,0,0,0,0,0,0,0,0,0,0,0,0,0
971,Jammu & Kashmir,2008,Total,329,9,338,1631,75,1706,265,1,266,0,0,0,2225,85,2310
972,Jammu & Kashmir,2009,Central Jail,162,0,162,531,18,549,139,1,140,1,0,1,833,19,852
973,Jammu & Kashmir,2009,District Jail,180,12,192,1052,67,1119,38,0,38,0,0,0,1270,79,1349
974,Jammu & Kashmir,2009,Sub_Jail,4,0,4,153,0,153,4,0,4,0,0,0,161,0,161
975,Jammu & Kashmir,2009,Women Jail,0,0,0,0,0,0,0,0,0,0,0,0,0,0,0
976,Jammu & Kashmir,2009,Borstal School,0,0,0,0,0,0,0,0,0,0,0,0,0,0,0
977,Jammu & Kashmir,2009,Open Jail,0,0,0,0,0,0,0,0,0,0,0,0,0,0,0
978,Jammu & Kashmir,2009,Special Jail,0,0,0,0,0,0,0,0,0,0,0,0,0,0,0
979,Jammu & Kashmir,2009,Others,0,0,0,0,0,0,0,0,0,0,0,0,0,0,0
980,Jammu & Kashmir,2009,Total,346,12,358,1736,85,1821,181,1,182,1,0,1,2264,98,2362
981,Jammu & Kashmir,2010,Central Jail,152,0,152,584,11,595,269,13,282,1,0,1,1006,24,1030
982,Jammu & Kashmir,2010,District Jail,99,7,106,1137,73,1210,111,2,113,1,0,1,1348,82,1430
983,Jammu & Kashmir,2010,Sub_Jail,1,0,1,102,0,102,14,0,14,0,0,0,117,0,117
984,Jammu & Kashmir,2010,Women Jail,0,0,0,0,0,0,0,0,0,0,0,0,0,0,0
985,Jammu & Kashmir,2010,Borstal School,0,0,0,0,0,0,0,0,0,0,0,0,0,0,0
986,Jammu & Kashmir,2010,Open Jail,0,0,0,0,0,0,0,0,0,0,0,0,0,0,0
987,Jammu & Kashmir,2010,Special Jail,0,0,0,0,0,0,0,0,0,0,0,0,0,0,0
988,Jammu & Kashmir,2010,Others,0,0,0,0,0,0,0,0,0,0,0,0,0,0,0
989,Jammu & Kashmir,2010,Total,252,7,259,1823,84,1907,394,15,409,2,0,2,2471,106,2577
990,Jammu & Kashmir,2011,Central Jail,194,2,196,693,20,713,161,5,166,9,0,9,1057,27,1084
991,Jammu & Kashmir,2011,District Jail,97,8,105,1169,68,1237,70,0,70,1,0,1,1337,76,1413
992,Jammu & Kashmir,2011,Sub_Jail,0,0,0,163,0,163,3,0,3,0,0,0,166,0,166
993,Jammu & Kashmir,2011,Women Jail,0,0,0,0,0,0,0,0,0,0,0,0,0,0,0
994,Jammu & Kashmir,2011,Borstal School,0,0,0,0,0,0,0,0,0,0,0,0,0,0,0
995,Jammu & Kashmir,2011,Open Jail,0,0,0,0,0,0,0,0,0,0,0,0,0,0,0
996,Jammu & Kashmir,2011,Special Jail,0,0,0,0,0,0,0,0,0,0,0,0,0,0,0
997,Jammu & Kashmir,2011,Others,0,0,0,0,0,0,0,0,0,0,0,0,0,0,0
998,Jammu & Kashmir,2011,Total,291,10,301,2025,88,2113,234,5,239,10,0,10,2560,103,2663
999,Jammu & Kashmir,2012,Central Jail,220,5,225,613,2,615,86,0,86,0,0,0,919,7,926
1000,Jammu & Kashmir,2012,District Jail,156,8,164,1212,78,1290,49,0,49,0,0,0,1417,86,1503
1001,Jammu & Kashmir,2012,Sub_Jail,0,0,0,102,0,102,9,0,9,0,0,0,111,0,111
1002,Jammu & Kashmir,2012,Women Jail,0,0,0,0,0,0,0,0,0,0,0,0,0,0,0
1003,Jammu & Kashmir,2012,Borstal School,0,0,0,0,0,0,0,0,0,0,0,0,0,0,0
1004,Jammu & Kashmir,2012,Open Jail,0,0,0,0,0,0,0,0,0,0,0,0,0,0,0
1005,Jammu & Kashmir,2012,Special Jail,0,0,0,0,0,0,0,0,0,0,0,0,0,0,0
1006,Jammu & Kashmir,2012,Others,0,0,0,0,0,0,0,0,0,0,0,0,0,0,0
1007,Jammu & Kashmir,2012,Total,376,13,389,1927,80,2007,144,0,144,0,0,0,2447,93,2540
1008,Jharkhand,2001,Central Jail,1875,26,1901,2415,43,2458,6,0,6,0,0,0,4296,69,4365
1009,Jharkhand,2001,District Jail,295,9,304,5137,166,5303,3,0,3,6,0,6,5441,175,5616
1010,Jharkhand,2001,Sub_Jail,201,14,215,6089,183,6272,0,0,0,4,0,4,6294,197,6491
1011,Jharkhand,2001,Women Jail,0,0,0,0,0,0,0,0,0,0,0,0,0,0,0
1012,Jharkhand,2001,Borstal School,0,0,0,45,0,45,0,0,0,0,0,0,45,0,45
1013,Jharkhand,2001,Open Jail,0,0,0,0,0,0,0,0,0,0,0,0,0,0,0
1014,Jharkhand,2001,Special Jail,0,0,0,0,0,0,0,0,0,0,0,0,0,0,0
1015,Jharkhand,2001,Others,0,0,0,0,0,0,0,0,0,0,0,0,0,0,0
1016,Jharkhand,2001,Total,2371,49,2420,13686,392,14078,9,0,9,10,0,10,16076,441,16517
1017,Jharkhand,2002,Central Jail,2288,55,2343,1937,59,1996,16,0,16,2,0,2,4243,114,4357
1018,Jharkhand,2002,District Jail,362,7,369,3995,158,4153,1,0,1,0,0,0,4358,165,4523
1019,Jharkhand,2002,Sub_Jail,292,9,301,5730,188,5918,1,0,1,1,0,1,6024,197,6221
1020,Jharkhand,2002,Women Jail,0,0,0,0,0,0,0,0,0,0,0,0,0,0,0
1021,Jharkhand,2002,Borstal School,0,0,0,27,0,27,0,0,0,0,0,0,27,0,27
1022,Jharkhand,2002,Open Jail,0,0,0,0,0,0,0,0,0,0,0,0,0,0,0
1023,Jharkhand,2002,Special Jail,0,0,0,0,0,0,0,0,0,0,0,0,0,0,0
1024,Jharkhand,2002,Others,0,0,0,0,0,0,0,0,0,0,0,0,0,0,0
1025,Jharkhand,2002,Total,2942,71,3013,11689,405,12094,18,0,18,3,0,3,14652,476,15128
1026,Jharkhand,2003,Central Jail,3195,104,3299,3397,87,3484,11,0,11,1,0,1,6604,191,6795
1027,Jharkhand,2003,District Jail,519,14,533,2897,126,3023,0,0,0,1,0,1,3417,140,3557
1028,Jharkhand,2003,Sub_Jail,413,9,422,5389,201,5590,2,0,2,9,0,9,5813,210,6023
1029,Jharkhand,2003,Women Jail,0,0,0,0,0,0,0,0,0,0,0,0,0,0,0
1030,Jharkhand,2003,Borstal School,3,0,3,37,0,37,0,0,0,0,0,0,40,0,40
1031,Jharkhand,2003,Open Jail,0,0,0,0,0,0,0,0,0,0,0,0,0,0,0
1032,Jharkhand,2003,Special Jail,0,0,0,0,0,0,0,0,0,0,0,0,0,0,0
1033,Jharkhand,2003,Others,0,0,0,0,0,0,0,0,0,0,0,0,0,0,0
1034,Jharkhand,2003,Total,4130,127,4257,11720,414,12134,13,0,13,11,0,11,15874,541,16415
1035,Jharkhand,2004,Central Jail,3793,118,3911,2433,89,2522,10,0,10,0,0,0,6236,207,6443
1036,Jharkhand,2004,District Jail,655,12,667,4027,150,4177,0,0,0,0,0,0,4682,162,4844
1037,Jharkhand,2004,Sub_Jail,452,8,460,5454,254,5708,0,0,0,0,0,0,5906,262,6168
1038,Jharkhand,2004,Women Jail,0,0,0,0,0,0,0,0,0,0,0,0,0,0,0
1039,Jharkhand,2004,Borstal School,2,0,2,40,0,40,0,0,0,0,0,0,42,0,42
1040,Jharkhand,2004,Open Jail,0,0,0,0,0,0,0,0,0,0,0,0,0,0,0
1041,Jharkhand,2004,Special Jail,0,0,0,0,0,0,0,0,0,0,0,0,0,0,0
1042,Jharkhand,2004,Others,0,0,0,0,0,0,0,0,0,0,0,0,0,0,0
1043,Jharkhand,2004,Total,4902,138,5040,11954,493,12447,10,0,10,0,0,0,16866,631,17497
1044,Jharkhand,2005,Central Jail,4178,134,4312,3002,121,3123,0,0,0,0,0,0,7180,255,7435
1045,Jharkhand,2005,District Jail,909,18,927,8985,391,9376,0,0,0,0,0,0,9894,409,10303
1046,Jharkhand,2005,Sub_Jail,53,0,53,1378,34,1412,0,0,0,0,0,0,1431,34,1465
1047,Jharkhand,2005,Women Jail,0,0,0,0,0,0,0,0,0,0,0,0,0,0,0
1048,Jharkhand,2005,Borstal School,2,0,2,28,0,28,0,0,0,0,0,0,30,0,30
1049,Jharkhand,2005,Open Jail,0,0,0,0,0,0,0,0,0,0,0,0,0,0,0
1050,Jharkhand,2005,Special Jail,0,0,0,0,0,0,0,0,0,0,0,0,0,0,0
1051,Jharkhand,2005,Others,0,0,0,0,0,0,0,0,0,0,0,0,0,0,0
1052,Jharkhand,2005,Total,5142,152,5294,13393,546,13939,0,0,0,0,0,0,18535,698,19233
1053,Jharkhand,2006,Central Jail,6174,224,6398,3671,152,3823,1,0,1,0,0,0,9846,376,10222
1054,Jharkhand,2006,District Jail,908,22,930,8046,348,8394,0,0,0,0,0,0,8954,370,9324
1055,Jharkhand,2006,Sub_Jail,39,0,39,1046,33,1079,0,0,0,0,0,0,1085,33,1118
1056,Jharkhand,2006,Women Jail,0,0,0,0,0,0,0,0,0,0,0,0,0,0,0
1057,Jharkhand,2006,Borstal School,2,0,2,43,0,43,0,0,0,0,0,0,45,0,45
1058,Jharkhand,2006,Open Jail,0,0,0,0,0,0,0,0,0,0,0,0,0,0,0
1059,Jharkhand,2006,Special Jail,0,0,0,0,0,0,0,0,0,0,0,0,0,0,0
1060,Jharkhand,2006,Others,0,0,0,0,0,0,0,0,0,0,0,0,0,0,0
1061,Jharkhand,2006,Total,7123,246,7369,12806,533,13339,1,0,1,0,0,0,19930,779,20709
1062,Jharkhand,2007,Central Jail,4684,159,4843,2681,119,2800,2,0,2,0,0,0,7367,278,7645
1063,Jharkhand,2007,District Jail,928,25,953,7974,313,8287,4,0,4,2,0,2,8908,338,9246
1064,Jharkhand,2007,Sub_Jail,67,0,67,905,41,946,0,0,0,0,0,0,972,41,1013
1065,Jharkhand,2007,Women Jail,0,0,0,0,0,0,0,0,0,0,0,0,0,0,0
1066,Jharkhand,2007,Borstal School,2,0,2,30,0,30,0,0,0,0,0,0,32,0,32
1067,Jharkhand,2007,Open Jail,0,0,0,0,0,0,0,0,0,0,0,0,0,0,0
1068,Jharkhand,2007,Special Jail,0,0,0,0,0,0,0,0,0,0,0,0,0,0,0
1069,Jharkhand,2007,Others,0,0,0,0,0,0,0,0,0,0,0,0,0,0,0
1070,Jharkhand,2007,Total,5681,184,5865,11590,473,12063,6,0,6,2,0,2,17279,657,17936
1071,Jharkhand,2008,Central Jail,4695,150,4845,2900,127,3027,0,0,0,0,0,0,7595,277,7872
1072,Jharkhand,2008,District Jail,848,19,867,8204,318,8522,6,0,6,2,0,2,9060,337,9397
1073,Jharkhand,2008,Sub_Jail,70,1,71,987,37,1024,0,0,0,1,0,1,1058,38,1096
1074,Jharkhand,2008,Women Jail,0,0,0,0,0,0,0,0,0,0,0,0,0,0,0
1075,Jharkhand,2008,Borstal School,1,0,1,37,0,37,0,0,0,0,0,0,38,0,38
1076,Jharkhand,2008,Open Jail,0,0,0,0,0,0,0,0,0,0,0,0,0,0,0
1077,Jharkhand,2008,Special Jail,0,0,0,0,0,0,0,0,0,0,0,0,0,0,0
1078,Jharkhand,2008,Others,0,0,0,0,0,0,0,0,0,0,0,0,0,0,0
1079,Jharkhand,2008,Total,5614,170,5784,12128,482,12610,6,0,6,3,0,3,17751,652,18403
1080,Jharkhand,2009,Central Jail,4448,143,4591,2806,128,2934,0,0,0,0,0,0,7254,271,7525
1081,Jharkhand,2009,District Jail,812,23,835,7542,315,7857,5,0,5,0,0,0,8359,338,8697
1082,Jharkhand,2009,Sub_Jail,81,1,82,817,41,858,0,0,0,0,0,0,898,42,940
1083,Jharkhand,2009,Women Jail,0,0,0,0,0,0,0,0,0,0,0,0,0,0,0
1084,Jharkhand,2009,Borstal School,1,0,1,33,0,33,0,0,0,0,0,0,34,0,34
1085,Jharkhand,2009,Open Jail,0,0,0,0,0,0,0,0,0,0,0,0,0,0,0
1086,Jharkhand,2009,Special Jail,0,0,0,0,0,0,0,0,0,0,0,0,0,0,0
1087,Jharkhand,2009,Others,0,0,0,0,0,0,0,0,0,0,0,0,0,0,0
1088,Jharkhand,2009,Total,5342,167,5509,11198,484,11682,5,0,5,0,0,0,16545,651,17196
1089,Jharkhand,2010,Central Jail,4525,153,4678,4098,199,4297,12,0,12,0,0,0,8635,352,8987
1090,Jharkhand,2010,District Jail,524,15,539,7202,279,7481,4,0,4,0,0,0,7730,294,8024
1091,Jharkhand,2010,Sub_Jail,44,0,44,898,61,959,0,0,0,0,0,0,942,61,1003
1092,Jharkhand,2010,Women Jail,0,0,0,0,0,0,0,0,0,0,0,0,0,0,0
1093,Jharkhand,2010,Borstal School,0,0,0,28,0,28,0,0,0,0,0,0,28,0,28
1094,Jharkhand,2010,Open Jail,0,0,0,0,0,0,0,0,0,0,0,0,0,0,0
1095,Jharkhand,2010,Special Jail,0,0,0,0,0,0,0,0,0,0,0,0,0,0,0
1096,Jharkhand,2010,Others,0,0,0,0,0,0,0,0,0,0,0,0,0,0,0
1097,Jharkhand,2010,Total,5093,168,5261,12226,539,12765,16,0,16,0,0,0,17335,707,18042
1098,Jharkhand,2011,Central Jail,4067,133,4200,3831,202,4033,10,1,11,0,0,0,7908,336,8244
1099,Jharkhand,2011,District Jail,260,6,266,6705,328,7033,7,0,7,0,0,0,6972,334,7306
1100,Jharkhand,2011,Sub_Jail,27,0,27,937,48,985,0,0,0,2,0,2,966,48,1014
1101,Jharkhand,2011,Women Jail,0,0,0,0,0,0,0,0,0,0,0,0,0,0,0
1102,Jharkhand,2011,Borstal School,0,0,0,22,0,22,0,0,0,0,0,0,22,0,22
1103,Jharkhand,2011,Open Jail,0,0,0,0,0,0,0,0,0,0,0,0,0,0,0
1104,Jharkhand,2011,Special Jail,0,0,0,0,0,0,0,0,0,0,0,0,0,0,0
1105,Jharkhand,2011,Others,0,0,0,0,0,0,0,0,0,0,0,0,0,0,0
1106,Jharkhand,2011,Total,4354,139,4493,11495,578,12073,17,1,18,2,0,2,15868,718,16586
1107,Jharkhand,2012,Central Jail,3875,140,4015,3950,197,4147,15,0,15,0,0,0,7840,337,8177
1108,Jharkhand,2012,District Jail,233,3,236,7357,356,7713,1,0,1,0,0,0,7591,359,7950
1109,Jharkhand,2012,Sub_Jail,27,1,28,1083,47,1130,0,0,0,1,0,1,1111,48,1159
1110,Jharkhand,2012,Women Jail,0,0,0,0,0,0,0,0,0,0,0,0,0,0,0
1111,Jharkhand,2012,Borstal School,0,0,0,45,0,45,0,0,0,0,0,0,45,0,45
1112,Jharkhand,2012,Open Jail,0,0,0,0,0,0,0,0,0,0,0,0,0,0,0
1113,Jharkhand,2012,Special Jail,0,0,0,0,0,0,0,0,0,0,0,0,0,0,0
1114,Jharkhand,2012,Others,0,0,0,0,0,0,0,0,0,0,0,0,0,0,0
1115,Jharkhand,2012,Total,4135,144,4279,12435,600,13035,16,0,16,1,0,1,16587,744,17331
1116,Karnataka,2001,Central Jail,1659,54,1713,3897,112,4009,74,0,74,2,0,2,5632,166,5798
1117,Karnataka,2001,District Jail,34,0,34,931,31,962,39,0,39,0,0,0,1004,31,1035
1118,Karnataka,2001,Sub_Jail,28,0,28,2540,56,2596,9,0,9,3,0,3,2580,56,2636
1119,Karnataka,2001,Women Jail,0,0,0,0,0,0,0,0,0,0,0,0,0,0,0
1120,Karnataka,2001,Borstal School,0,0,0,0,0,0,0,0,0,0,0,0,0,0,0
1121,Karnataka,2001,Open Jail,44,0,44,0,0,0,0,0,0,0,0,0,44,0,44
1122,Karnataka,2001,Special Jail,0,0,0,149,0,149,0,0,0,0,0,0,149,0,149
1123,Karnataka,2001,Others,84,0,84,0,0,0,0,0,0,0,0,0,84,0,84
1124,Karnataka,2001,Total,1849,54,1903,7517,199,7716,122,0,122,5,0,5,9493,253,9746
1125,Karnataka,2002,Central Jail,2030,80,2110,3873,165,4038,79,2,81,9,0,9,5991,247,6238
1126,Karnataka,2002,District Jail,32,2,34,1091,43,1134,26,1,27,2,0,2,1151,46,1197
1127,Karnataka,2002,Sub_Jail,62,1,63,2603,55,2658,15,1,16,7,0,7,2687,57,2744
1128,Karnataka,2002,Women Jail,0,0,0,0,0,0,0,0,0,0,0,0,0,0,0
1129,Karnataka,2002,Borstal School,0,0,0,0,0,0,0,0,0,0,0,0,0,0,0
1130,Karnataka,2002,Open Jail,27,0,27,0,0,0,0,0,0,0,0,0,27,0,27
1131,Karnataka,2002,Special Jail,3,0,3,142,0,142,0,0,0,0,0,0,145,0,145
1132,Karnataka,2002,Others,61,0,61,0,0,0,0,0,0,0,0,0,61,0,61
1133,Karnataka,2002,Total,2215,83,2298,7709,263,7972,120,4,124,18,0,18,10062,350,10412
1134,Karnataka,2003,Central Jail,2484,78,2562,4050,177,4227,86,0,86,3,0,3,6623,255,6878
1135,Karnataka,2003,District Jail,28,0,28,942,44,986,28,2,30,12,0,12,1010,46,1056
1136,Karnataka,2003,Sub_Jail,83,0,83,2547,40,2587,16,1,17,6,0,6,2652,41,2693
1137,Karnataka,2003,Women Jail,0,0,0,0,0,0,0,0,0,0,0,0,0,0,0
1138,Karnataka,2003,Borstal School,0,0,0,0,0,0,0,0,0,0,0,0,0,0,0
1139,Karnataka,2003,Open Jail,24,0,24,0,0,0,0,0,0,0,0,0,24,0,24
1140,Karnataka,2003,Special Jail,22,0,22,175,0,175,0,0,0,0,0,0,197,0,197
1141,Karnataka,2003,Others,54,0,54,0,0,0,0,0,0,0,0,0,54,0,54
1142,Karnataka,2003,Total,2695,78,2773,7714,261,7975,130,3,133,21,0,21,10560,342,10902
1143,Karnataka,2004,Central Jail,3125,120,3245,3821,193,4014,85,0,85,4,0,4,7035,313,7348
1144,Karnataka,2004,District Jail,31,2,33,821,55,876,17,2,19,0,0,0,869,59,928
1145,Karnataka,2004,Sub_Jail,60,4,64,2786,59,2845,17,1,18,7,0,7,2870,64,2934
1146,Karnataka,2004,Women Jail,0,0,0,0,0,0,0,0,0,0,0,0,0,0,0
1147,Karnataka,2004,Borstal School,0,0,0,0,0,0,0,0,0,0,0,0,0,0,0
1148,Karnataka,2004,Open Jail,25,0,25,0,0,0,0,0,0,0,0,0,25,0,25
1149,Karnataka,2004,Special Jail,16,0,16,227,0,227,0,0,0,0,0,0,243,0,243
1150,Karnataka,2004,Others,64,0,64,0,0,0,0,0,0,0,0,0,64,0,64
1151,Karnataka,2004,Total,3321,126,3447,7655,307,7962,119,3,122,11,0,11,11106,436,11542
1152,Karnataka,2005,Central Jail,3667,143,3810,4078,188,4266,91,1,92,31,0,31,7867,332,8199
1153,Karnataka,2005,District Jail,40,1,41,919,43,962,40,5,45,3,0,3,1002,49,1051
1154,Karnataka,2005,Sub_Jail,88,0,88,2518,65,2583,19,2,21,5,0,5,2630,67,2697
1155,Karnataka,2005,Women Jail,0,0,0,0,0,0,0,0,0,0,0,0,0,0,0
1156,Karnataka,2005,Borstal School,0,0,0,0,0,0,0,0,0,0,0,0,0,0,0
1157,Karnataka,2005,Open Jail,37,0,37,0,0,0,0,0,0,0,0,0,37,0,37
1158,Karnataka,2005,Special Jail,15,0,15,168,0,168,0,0,0,2,0,2,185,0,185
1159,Karnataka,2005,Others,58,0,58,0,0,0,0,0,0,0,0,0,58,0,58
1160,Karnataka,2005,Total,3905,144,4049,7683,296,7979,150,8,158,41,0,41,11779,448,12227
1161,Karnataka,2006,Central Jail,3485,182,3667,4503,215,4718,78,3,81,11,0,11,8077,400,8477
1162,Karnataka,2006,District Jail,41,1,42,951,45,996,78,7,85,9,0,9,1079,53,1132
1163,Karnataka,2006,Sub_Jail,77,2,79,2711,51,2762,9,0,9,4,0,4,2801,53,2854
1164,Karnataka,2006,Women Jail,0,0,0,0,0,0,0,0,0,0,0,0,0,0,0
1165,Karnataka,2006,Borstal School,0,0,0,0,0,0,0,0,0,0,0,0,0,0,0
1166,Karnataka,2006,Open Jail,33,0,33,0,0,0,0,0,0,0,0,0,33,0,33
1167,Karnataka,2006,Special Jail,7,0,7,173,0,173,0,0,0,0,0,0,180,0,180
1168,Karnataka,2006,Others,24,0,24,0,0,0,0,0,0,0,0,0,24,0,24
1169,Karnataka,2006,Total,3667,185,3852,8338,311,8649,165,10,175,24,0,24,12194,506,12700
1170,Karnataka,2007,Central Jail,3499,170,3669,4897,218,5115,9,0,9,64,4,68,8469,392,8861
1171,Karnataka,2007,District Jail,66,0,66,1610,99,1709,1,0,1,90,2,92,1767,101,1868
1172,Karnataka,2007,Sub_Jail,31,0,31,2024,35,2059,0,0,0,6,0,6,2061,35,2096
1173,Karnataka,2007,Women Jail,0,0,0,0,0,0,0,0,0,0,0,0,0,0,0
1174,Karnataka,2007,Borstal School,0,0,0,0,0,0,0,0,0,0,0,0,0,0,0
1175,Karnataka,2007,Open Jail,32,0,32,0,0,0,0,0,0,0,0,0,32,0,32
1176,Karnataka,2007,Special Jail,8,0,8,163,0,163,0,0,0,0,0,0,171,0,171
1177,Karnataka,2007,Others,24,0,24,0,0,0,0,0,0,0,0,0,24,0,24
1178,Karnataka,2007,Total,3660,170,3830,8694,352,9046,10,0,10,160,6,166,12524,528,13052
1179,Karnataka,2008,Central Jail,3646,177,3823,5006,227,5233,0,1,1,59,13,72,8711,418,9129
1180,Karnataka,2008,District Jail,51,0,51,1767,86,1853,0,0,0,83,1,84,1901,87,1988
1181,Karnataka,2008,Sub_Jail,37,2,39,2063,41,2104,0,0,0,14,0,14,2114,43,2157
1182,Karnataka,2008,Women Jail,0,0,0,0,0,0,0,0,0,0,0,0,0,0,0
1183,Karnataka,2008,Borstal School,0,0,0,0,0,0,0,0,0,0,0,0,0,0,0
1184,Karnataka,2008,Open Jail,26,0,26,0,0,0,0,0,0,0,0,0,26,0,26
1185,Karnataka,2008,Special Jail,12,0,12,218,0,218,0,0,0,0,0,0,230,0,230
1186,Karnataka,2008,Others,8,0,8,0,0,0,0,0,0,0,0,0,8,0,8
1187,Karnataka,2008,Total,3780,179,3959,9054,354,9408,0,1,1,156,14,170,12990,548,13538
1188,Karnataka,2009,Central Jail,3453,149,3602,4689,210,4899,2,1,3,124,6,130,8268,366,8634
1189,Karnataka,2009,District Jail,61,2,63,1904,98,2002,13,0,13,42,4,46,2020,104,2124
1190,Karnataka,2009,Sub_Jail,28,0,28,2153,53,2206,1,0,1,7,1,8,2189,54,2243
1191,Karnataka,2009,Women Jail,0,0,0,0,0,0,0,0,0,0,0,0,0,0,0
1192,Karnataka,2009,Borstal School,0,0,0,0,0,0,0,0,0,0,0,0,0,0,0
1193,Karnataka,2009,Open Jail,19,0,19,0,0,0,0,0,0,0,0,0,19,0,19
1194,Karnataka,2009,Special Jail,3,0,3,214,0,214,0,0,0,1,0,1,218,0,218
1195,Karnataka,2009,Others,3,0,3,0,0,0,0,0,0,0,0,0,3,0,3
1196,Karnataka,2009,Total,3567,151,3718,8960,361,9321,16,1,17,174,11,185,12717,524,13241
1197,Karnataka,2010,Central Jail,3629,162,3791,4296,199,4495,9,1,10,122,1,123,8056,363,8419
1198,Karnataka,2010,District Jail,60,1,61,2002,58,2060,1,1,2,37,1,38,2100,61,2161
1199,Karnataka,2010,Sub_Jail,35,2,37,1966,43,2009,0,0,0,11,0,11,2012,45,2057
1200,Karnataka,2010,Women Jail,0,0,0,0,0,0,0,0,0,0,0,0,0,0,0
1201,Karnataka,2010,Borstal School,0,0,0,0,0,0,0,0,0,0,0,0,0,0,0
1202,Karnataka,2010,Open Jail,31,0,31,0,0,0,0,0,0,0,0,0,31,0,31
1203,Karnataka,2010,Special Jail,3,0,3,212,0,212,0,0,0,6,0,6,221,0,221
1204,Karnataka,2010,Others,0,0,0,0,0,0,0,0,0,0,0,0,0,0,0
1205,Karnataka,2010,Total,3758,165,3923,8476,300,8776,10,2,12,176,2,178,12420,469,12889
1206,Karnataka,2011,Central Jail,3887,187,4074,4148,209,4357,6,0,6,105,8,113,8146,404,8550
1207,Karnataka,2011,District Jail,58,0,58,1834,68,1902,0,0,0,28,1,29,1920,69,1989
1208,Karnataka,2011,Sub_Jail,23,1,24,1831,49,1880,0,0,0,8,0,8,1862,50,1912
1209,Karnataka,2011,Women Jail,0,0,0,0,0,0,0,0,0,0,0,0,0,0,0
1210,Karnataka,2011,Borstal School,0,0,0,0,0,0,0,0,0,0,0,0,0,0,0
1211,Karnataka,2011,Open Jail,57,0,57,0,0,0,0,0,0,0,0,0,57,0,57
1212,Karnataka,2011,Special Jail,8,0,8,147,0,147,0,0,0,3,0,3,158,0,158
1213,Karnataka,2011,Others,0,0,0,0,0,0,0,0,0,0,0,0,0,0,0
1214,Karnataka,2011,Total,4033,188,4221,7960,326,8286,6,0,6,144,9,153,12143,523,12666
1215,Karnataka,2012,Central Jail,3757,184,3941,4359,221,4580,67,0,67,0,0,0,8183,405,8588
1216,Karnataka,2012,District Jail,71,1,72,2098,90,2188,15,3,18,0,0,0,2184,94,2278
1217,Karnataka,2012,Sub_Jail,33,2,35,1912,57,1969,9,0,9,0,0,0,1954,59,2013
1218,Karnataka,2012,Women Jail,0,0,0,0,0,0,0,0,0,0,0,0,0,0,0
1219,Karnataka,2012,Borstal School,0,0,0,0,0,0,0,0,0,0,0,0,0,0,0
1220,Karnataka,2012,Open Jail,51,0,51,0,0,0,0,0,0,0,0,0,51,0,51
1221,Karnataka,2012,Special Jail,1,0,1,203,0,203,3,0,3,0,0,0,207,0,207
1222,Karnataka,2012,Others,0,0,0,0,0,0,0,0,0,0,0,0,0,0,0
1223,Karnataka,2012,Total,3913,187,4100,8572,368,8940,94,3,97,0,0,0,12579,558,13137
1224,Kerala,2001,Central Jail,1521,28,1549,1001,28,1029,19,0,19,13,0,13,2554,56,2610
1225,Kerala,2001,District Jail,50,3,53,662,30,692,0,0,0,0,0,0,712,33,745
1226,Kerala,2001,Sub_Jail,47,2,49,1395,31,1426,0,0,0,0,0,0,1442,33,1475
1227,Kerala,2001,Women Jail,0,33,33,0,14,14,0,0,0,0,0,0,0,47,47
1228,Kerala,2001,Borstal School,1,0,1,0,0,0,0,0,0,0,0,0,1,0,1
1229,Kerala,2001,Open Jail,125,0,125,0,0,0,0,0,0,0,0,0,125,0,125
1230,Kerala,2001,Special Jail,6,1,7,358,8,366,0,0,0,0,0,0,364,9,373
1231,Kerala,2001,Others,0,0,0,0,0,0,0,0,0,0,0,0,0,0,0
1232,Kerala,2001,Total,1750,67,1817,3416,111,3527,19,0,19,13,0,13,5198,178,5376
1233,Kerala,2002,Central Jail,1405,28,1433,884,29,913,12,0,12,7,0,7,2308,57,2365
1234,Kerala,2002,District Jail,39,3,42,704,18,722,0,0,0,0,0,0,743,21,764
1235,Kerala,2002,Sub_Jail,30,0,30,1427,69,1496,0,0,0,0,0,0,1457,69,1526
1236,Kerala,2002,Women Jail,0,18,18,0,17,17,0,0,0,0,0,0,0,35,35
1237,Kerala,2002,Borstal School,1,0,1,0,0,0,0,0,0,0,0,0,1,0,1
1238,Kerala,2002,Open Jail,172,0,172,0,0,0,0,0,0,0,0,0,172,0,172
1239,Kerala,2002,Special Jail,14,1,15,306,4,310,0,0,0,0,0,0,320,5,325
1240,Kerala,2002,Others,0,0,0,0,0,0,0,0,0,0,0,0,0,0,0
1241,Kerala,2002,Total,1661,50,1711,3321,137,3458,12,0,12,7,0,7,5001,187,5188
1242,Kerala,2003,Central Jail,1779,42,1821,1487,52,1539,8,0,8,6,0,6,3280,94,3374
1243,Kerala,2003,District Jail,64,4,68,769,17,786,0,0,0,0,0,0,833,21,854
1244,Kerala,2003,Sub_Jail,30,1,31,1383,23,1406,0,0,0,0,0,0,1413,24,1437
1245,Kerala,2003,Women Jail,0,17,17,0,24,24,0,0,0,0,0,0,0,41,41
1246,Kerala,2003,Borstal School,0,0,0,0,0,0,0,0,0,0,0,0,0,0,0
1247,Kerala,2003,Open Jail,233,0,233,0,0,0,0,0,0,0,0,0,233,0,233
1248,Kerala,2003,Special Jail,19,3,22,483,20,503,0,0,0,0,0,0,502,23,525
1249,Kerala,2003,Others,0,0,0,0,0,0,0,0,0,0,0,0,0,0,0
1250,Kerala,2003,Total,2125,67,2192,4122,136,4258,8,0,8,6,0,6,6261,203,6464
1251,Kerala,2004,Central Jail,2331,57,2388,1248,48,1296,8,0,8,6,0,6,3593,105,3698
1252,Kerala,2004,District Jail,61,1,62,958,19,977,0,0,0,0,0,0,1019,20,1039
1253,Kerala,2004,Sub_Jail,39,2,41,1461,45,1506,0,0,0,0,0,0,1500,47,1547
1254,Kerala,2004,Women Jail,0,23,23,0,25,25,0,0,0,0,0,0,0,48,48
1255,Kerala,2004,Borstal School,0,0,0,0,0,0,0,0,0,0,0,0,0,0,0
1256,Kerala,2004,Open Jail,234,0,234,0,0,0,0,0,0,0,0,0,234,0,234
1257,Kerala,2004,Special Jail,31,1,32,579,17,596,0,0,0,0,0,0,610,18,628
1258,Kerala,2004,Others,0,0,0,0,0,0,0,0,0,0,0,0,0,0,0
1259,Kerala,2004,Total,2696,84,2780,4246,154,4400,8,0,8,6,0,6,6956,238,7194
1260,Kerala,2005,Central Jail,2330,48,2378,1257,30,1287,13,0,13,2,0,2,3602,78,3680
1261,Kerala,2005,District Jail,67,1,68,732,21,753,0,0,0,0,0,0,799,22,821
1262,Kerala,2005,Sub_Jail,39,0,39,1336,34,1370,0,0,0,0,0,0,1375,34,1409
1263,Kerala,2005,Women Jail,0,28,28,0,22,22,0,0,0,0,0,0,0,50,50
1264,Kerala,2005,Borstal School,0,0,0,0,0,0,0,0,0,0,0,0,0,0,0
1265,Kerala,2005,Open Jail,262,0,262,0,0,0,0,0,0,0,0,0,262,0,262
1266,Kerala,2005,Special Jail,31,0,31,593,17,610,0,0,0,0,0,0,624,17,641
1267,Kerala,2005,Others,0,0,0,0,0,0,0,0,0,0,0,0,0,0,0
1268,Kerala,2005,Total,2729,77,2806,3918,124,4042,13,0,13,2,0,2,6662,201,6863
1269,Kerala,2006,Central Jail,2453,32,2485,919,42,961,5,0,5,4,0,4,3381,74,3455
1270,Kerala,2006,District Jail,71,7,78,723,17,740,0,0,0,0,0,0,794,24,818
1271,Kerala,2006,Sub_Jail,22,0,22,1393,26,1419,0,0,0,0,0,0,1415,26,1441
1272,Kerala,2006,Women Jail,0,25,25,0,21,21,0,0,0,0,0,0,0,46,46
1273,Kerala,2006,Borstal School,0,0,0,0,0,0,0,0,0,0,0,0,0,0,0
1274,Kerala,2006,Open Jail,254,0,254,0,0,0,0,0,0,0,0,0,254,0,254
1275,Kerala,2006,Special Jail,12,0,12,459,19,478,0,0,0,0,0,0,471,19,490
1276,Kerala,2006,Others,0,0,0,0,0,0,0,0,0,0,0,0,0,0,0
1277,Kerala,2006,Total,2812,64,2876,3494,125,3619,5,0,5,4,0,4,6315,189,6504
1278,Kerala,2007,Central Jail,2457,27,2484,789,35,824,32,0,32,7,0,7,3285,62,3347
1279,Kerala,2007,District Jail,63,5,68,700,13,713,0,0,0,0,0,0,763,18,781
1280,Kerala,2007,Sub_Jail,28,1,29,1649,38,1687,0,0,0,0,0,0,1677,39,1716
1281,Kerala,2007,Women Jail,0,24,24,0,35,35,0,0,0,0,0,0,0,59,59
1282,Kerala,2007,Borstal School,0,0,0,0,0,0,0,0,0,0,0,0,0,0,0
1283,Kerala,2007,Open Jail,291,0,291,0,0,0,0,0,0,0,0,0,291,0,291
1284,Kerala,2007,Special Jail,19,1,20,524,4,528,0,0,0,0,0,0,543,5,548
1285,Kerala,2007,Others,0,0,0,0,0,0,0,0,0,0,0,0,0,0,0
1286,Kerala,2007,Total,2858,58,2916,3662,125,3787,32,0,32,7,0,7,6559,183,6742
1287,Kerala,2008,Central Jail,2230,30,2260,869,35,904,41,0,41,7,0,7,3147,65,3212
1288,Kerala,2008,District Jail,93,1,94,713,17,730,0,0,0,0,0,0,806,18,824
1289,Kerala,2008,Sub_Jail,26,0,26,1710,49,1759,0,0,0,0,0,0,1736,49,1785
1290,Kerala,2008,Women Jail,0,22,22,0,17,17,0,0,0,0,0,0,0,39,39
1291,Kerala,2008,Borstal School,0,0,0,0,0,0,0,0,0,0,0,0,0,0,0
1292,Kerala,2008,Open Jail,321,0,321,0,0,0,0,0,0,0,0,0,321,0,321
1293,Kerala,2008,Special Jail,26,1,27,514,10,524,0,0,0,0,0,0,540,11,551
1294,Kerala,2008,Others,0,0,0,0,0,0,0,0,0,0,0,0,0,0,0
1295,Kerala,2008,Total,2696,54,2750,3806,128,3934,41,0,41,7,0,7,6550,182,6732
1296,Kerala,2009,Central Jail,2373,21,2394,885,60,945,70,0,70,3,0,3,3331,81,3412
1297,Kerala,2009,District Jail,51,1,52,854,16,870,0,0,0,0,0,0,905,17,922
1298,Kerala,2009,Sub_Jail,25,0,25,1567,39,1606,0,0,0,0,0,0,1592,39,1631
1299,Kerala,2009,Women Jail,0,31,31,0,21,21,0,0,0,0,0,0,0,52,52
1300,Kerala,2009,Borstal School,0,0,0,0,0,0,0,0,0,0,0,0,0,0,0
1301,Kerala,2009,Open Jail,312,0,312,0,0,0,0,0,0,0,0,0,312,0,312
1302,Kerala,2009,Special Jail,6,0,6,619,17,636,0,0,0,0,0,0,625,17,642
1303,Kerala,2009,Others,0,0,0,0,0,0,0,0,0,0,0,0,0,0,0
1304,Kerala,2009,Total,2767,53,2820,3925,153,4078,70,0,70,3,0,3,6765,206,6971
1305,Kerala,2010,Central Jail,2326,13,2339,520,45,565,6,0,6,3,0,3,2855,58,2913
1306,Kerala,2010,District Jail,55,3,58,544,18,562,0,0,0,0,0,0,599,21,620
1307,Kerala,2010,Sub_Jail,18,0,18,1999,30,2029,0,0,0,0,0,0,2017,30,2047
1308,Kerala,2010,Women Jail,0,34,34,0,44,44,0,0,0,0,0,0,0,78,78
1309,Kerala,2010,Borstal School,0,0,0,0,0,0,0,0,0,0,0,0,0,0,0
1310,Kerala,2010,Open Jail,333,0,333,0,0,0,0,0,0,0,0,0,333,0,333
1311,Kerala,2010,Special Jail,2,0,2,674,25,699,0,0,0,0,0,0,676,25,701
1312,Kerala,2010,Others,0,0,0,0,0,0,0,0,0,0,0,0,0,0,0
1313,Kerala,2010,Total,2734,50,2784,3737,162,3899,6,0,6,3,0,3,6480,212,6692
1314,Kerala,2011,Central Jail,1957,0,1957,328,0,328,8,0,8,3,0,3,2296,0,2296
1315,Kerala,2011,District Jail,88,3,91,1019,17,1036,0,0,0,0,0,0,1107,20,1127
1316,Kerala,2011,Sub_Jail,24,1,25,1428,27,1455,0,0,0,0,0,0,1452,28,1480
1317,Kerala,2011,Women Jail,0,51,51,0,60,60,0,0,0,0,2,2,0,113,113
1318,Kerala,2011,Borstal School,0,0,0,0,0,0,0,0,0,0,0,0,0,0,0
1319,Kerala,2011,Open Jail,308,0,308,0,0,0,0,0,0,0,0,0,308,0,308
1320,Kerala,2011,Special Jail,9,0,9,885,11,896,0,0,0,0,0,0,894,11,905
1321,Kerala,2011,Others,0,0,0,0,0,0,0,0,0,0,0,0,0,0,0
1322,Kerala,2011,Total,2386,55,2441,3660,115,3775,8,0,8,3,2,5,6057,172,6229
1323,Kerala,2012,Central Jail,2023,0,2023,758,0,758,9,0,9,4,0,4,2794,0,2794
1324,Kerala,2012,District Jail,96,1,97,1085,17,1102,0,0,0,0,0,0,1181,18,1199
1325,Kerala,2012,Sub_Jail,98,0,98,1262,22,1284,0,0,0,0,0,0,1360,22,1382
1326,Kerala,2012,Women Jail,0,55,55,0,69,69,0,0,0,0,3,3,0,127,127
1327,Kerala,2012,Borstal School,0,0,0,50,13,63,0,0,0,0,0,0,50,13,63
1328,Kerala,2012,Open Jail,463,0,463,0,0,0,0,0,0,0,0,0,463,0,463
1329,Kerala,2012,Special Jail,30,0,30,865,24,889,0,0,0,0,0,0,895,24,919
1330,Kerala,2012,Others,0,0,0,0,0,0,0,0,0,0,0,0,0,0,0
1331,Kerala,2012,Total,2710,56,2766,4020,145,4165,9,0,9,4,3,7,6743,204,6947
1332,Madhya Pradesh,2001,Central Jail,9871,232,10103,4059,163,4222,10,0,10,15,0,15,13955,395,14350
1333,Madhya Pradesh,2001,District Jail,1206,30,1236,4982,218,5200,6,0,6,19,0,19,6213,248,6461
1334,Madhya Pradesh,2001,Sub_Jail,657,0,657,7341,74,7415,0,0,0,5,0,5,8003,74,8077
1335,Madhya Pradesh,2001,Women Jail,0,0,0,0,0,0,0,0,0,0,0,0,0,0,0
1336,Madhya Pradesh,2001,Borstal School,199,0,199,0,0,0,0,0,0,0,0,0,199,0,199
1337,Madhya Pradesh,2001,Open Jail,0,0,0,0,0,0,0,0,0,0,0,0,0,0,0
1338,Madhya Pradesh,2001,Special Jail,0,0,0,0,0,0,0,0,0,0,0,0,0,0,0
1339,Madhya Pradesh,2001,Others,0,0,0,0,0,0,0,0,0,0,0,0,0,0,0
1340,Madhya Pradesh,2001,Total,11933,262,12195,16382,455,16837,16,0,16,39,0,39,28370,717,29087
1341,Madhya Pradesh,2002,Central Jail,9857,221,10078,3902,174,4076,13,0,13,38,1,39,13810,396,14206
1342,Madhya Pradesh,2002,District Jail,1147,38,1185,3977,220,4197,3,0,3,10,0,10,5137,258,5395
1343,Madhya Pradesh,2002,Sub_Jail,642,1,643,7297,65,7362,0,0,0,10,0,10,7949,66,8015
1344,Madhya Pradesh,2002,Women Jail,0,0,0,0,0,0,0,0,0,0,0,0,0,0,0
1345,Madhya Pradesh,2002,Borstal School,151,0,151,0,0,0,0,0,0,0,0,0,151,0,151
1346,Madhya Pradesh,2002,Open Jail,0,0,0,0,0,0,0,0,0,0,0,0,0,0,0
1347,Madhya Pradesh,2002,Special Jail,0,0,0,0,0,0,0,0,0,0,0,0,0,0,0
1348,Madhya Pradesh,2002,Others,0,0,0,0,0,0,0,0,0,0,0,0,0,0,0
1349,Madhya Pradesh,2002,Total,11797,260,12057,15176,459,15635,16,0,16,58,1,59,27047,720,27767
1350,Madhya Pradesh,2003,Central Jail,9927,226,10153,3723,193,3916,9,0,9,20,0,20,13679,419,14098
1351,Madhya Pradesh,2003,District Jail,1204,318,1522,3315,189,3504,2,0,2,11,0,11,4532,507,5039
1352,Madhya Pradesh,2003,Sub_Jail,957,1,958,6500,73,6573,2,0,2,15,0,15,7474,74,7548
1353,Madhya Pradesh,2003,Women Jail,0,0,0,0,0,0,0,0,0,0,0,0,0,0,0
1354,Madhya Pradesh,2003,Borstal School,147,0,147,0,0,0,0,0,0,0,0,0,147,0,147
1355,Madhya Pradesh,2003,Open Jail,0,0,0,0,0,0,0,0,0,0,0,0,0,0,0
1356,Madhya Pradesh,2003,Special Jail,0,0,0,0,0,0,0,0,0,0,0,0,0,0,0
1357,Madhya Pradesh,2003,Others,0,0,0,0,0,0,0,0,0,0,0,0,0,0,0
1358,Madhya Pradesh,2003,Total,12235,545,12780,13538,455,13993,13,0,13,46,0,46,25832,1000,26832
1359,Madhya Pradesh,2004,Central Jail,10213,225,10438,4400,179,4579,5,0,5,32,0,32,14650,404,15054
1360,Madhya Pradesh,2004,District Jail,1414,38,1452,4198,184,4382,0,0,0,29,0,29,5641,222,5863
1361,Madhya Pradesh,2004,Sub_Jail,1021,6,1027,6718,98,6816,0,0,0,23,0,23,7762,104,7866
1362,Madhya Pradesh,2004,Women Jail,0,0,0,0,0,0,0,0,0,0,0,0,0,0,0
1363,Madhya Pradesh,2004,Borstal School,149,0,149,0,0,0,0,0,0,0,0,0,149,0,149
1364,Madhya Pradesh,2004,Open Jail,0,0,0,0,0,0,0,0,0,0,0,0,0,0,0
1365,Madhya Pradesh,2004,Special Jail,0,0,0,0,0,0,0,0,0,0,0,0,0,0,0
1366,Madhya Pradesh,2004,Others,0,0,0,0,0,0,0,0,0,0,0,0,0,0,0
1367,Madhya Pradesh,2004,Total,12797,269,13066,15316,461,15777,5,0,5,84,0,84,28202,730,28932
1368,Madhya Pradesh,2005,Central Jail,11172,242,11414,4425,191,4616,21,0,21,23,0,23,15641,433,16074
1369,Madhya Pradesh,2005,District Jail,1608,51,1659,4411,240,4651,0,0,0,14,0,14,6033,291,6324
1370,Madhya Pradesh,2005,Sub_Jail,1128,4,1132,7635,89,7724,0,0,0,40,0,40,8803,93,8896
1371,Madhya Pradesh,2005,Women Jail,0,0,0,0,0,0,0,0,0,0,0,0,0,0,0
1372,Madhya Pradesh,2005,Borstal School,186,0,186,0,0,0,0,0,0,0,0,0,186,0,186
1373,Madhya Pradesh,2005,Open Jail,0,0,0,0,0,0,0,0,0,0,0,0,0,0,0
1374,Madhya Pradesh,2005,Special Jail,0,0,0,0,0,0,0,0,0,0,0,0,0,0,0
1375,Madhya Pradesh,2005,Others,0,0,0,0,0,0,0,0,0,0,0,0,0,0,0
1376,Madhya Pradesh,2005,Total,14094,297,14391,16471,520,16991,21,0,21,77,0,77,30663,817,31480
1377,Madhya Pradesh,2006,Central Jail,11982,277,12259,4578,173,4751,21,0,21,24,3,27,16605,453,17058
1378,Madhya Pradesh,2006,District Jail,1763,71,1834,4379,177,4556,0,0,0,18,0,18,6160,248,6408
1379,Madhya Pradesh,2006,Sub_Jail,1121,1,1122,7302,77,7379,0,0,0,33,0,33,8456,78,8534
1380,Madhya Pradesh,2006,Women Jail,0,0,0,0,0,0,0,0,0,0,0,0,0,0,0
1381,Madhya Pradesh,2006,Borstal School,0,0,0,0,0,0,0,0,0,0,0,0,0,0,0
1382,Madhya Pradesh,2006,Open Jail,0,0,0,0,0,0,0,0,0,0,0,0,0,0,0
1383,Madhya Pradesh,2006,Special Jail,0,0,0,0,0,0,0,0,0,0,0,0,0,0,0
1384,Madhya Pradesh,2006,Others,0,0,0,0,0,0,0,0,0,0,0,0,0,0,0
1385,Madhya Pradesh,2006,Total,14866,349,15215,16259,427,16686,21,0,21,75,3,78,31221,779,32000
1386,Madhya Pradesh,2007,Central Jail,12548,293,12841,4476,181,4657,34,0,34,24,0,24,17082,474,17556
1387,Madhya Pradesh,2007,District Jail,1911,69,1980,3993,212,4205,0,0,0,13,0,13,5917,281,6198
1388,Madhya Pradesh,2007,Sub_Jail,1481,11,1492,7350,88,7438,0,0,0,28,0,28,8859,99,8958
1389,Madhya Pradesh,2007,Women Jail,0,0,0,0,0,0,0,0,0,0,0,0,0,0,0
1390,Madhya Pradesh,2007,Borstal School,0,0,0,0,0,0,0,0,0,0,0,0,0,0,0
1391,Madhya Pradesh,2007,Open Jail,0,0,0,0,0,0,0,0,0,0,0,0,0,0,0
1392,Madhya Pradesh,2007,Special Jail,0,0,0,0,0,0,0,0,0,0,0,0,0,0,0
1393,Madhya Pradesh,2007,Others,0,0,0,0,0,0,0,0,0,0,0,0,0,0,0
1394,Madhya Pradesh,2007,Total,15940,373,16313,15819,481,16300,34,0,34,65,0,65,31858,854,32712
1395,Madhya Pradesh,2008,Central Jail,12136,290,12426,4888,242,5130,93,0,93,20,0,20,17137,532,17669
1396,Madhya Pradesh,2008,District Jail,1943,97,2040,5369,265,5634,10,0,10,24,0,24,7346,362,7708
1397,Madhya Pradesh,2008,Sub_Jail,1627,9,1636,7645,79,7724,0,0,0,18,0,18,9290,88,9378
1398,Madhya Pradesh,2008,Women Jail,0,0,0,0,0,0,0,0,0,0,0,0,0,0,0
1399,Madhya Pradesh,2008,Borstal School,0,0,0,0,0,0,0,0,0,0,0,0,0,0,0
1400,Madhya Pradesh,2008,Open Jail,0,0,0,0,0,0,0,0,0,0,0,0,0,0,0
1401,Madhya Pradesh,2008,Special Jail,0,0,0,0,0,0,0,0,0,0,0,0,0,0,0
1402,Madhya Pradesh,2008,Others,0,0,0,0,0,0,0,0,0,0,0,0,0,0,0
1403,Madhya Pradesh,2008,Total,15706,396,16102,17902,586,18488,103,0,103,62,0,62,33773,982,34755
1404,Madhya Pradesh,2009,Central Jail,11480,298,11778,4716,215,4931,51,0,51,27,0,27,16274,513,16787
1405,Madhya Pradesh,2009,District Jail,2127,93,2220,4824,249,5073,0,0,0,25,0,25,6976,342,7318
1406,Madhya Pradesh,2009,Sub_Jail,1360,9,1369,7240,67,7307,0,0,0,25,0,25,8625,76,8701
1407,Madhya Pradesh,2009,Women Jail,0,0,0,0,0,0,0,0,0,0,0,0,0,0,0
1408,Madhya Pradesh,2009,Borstal School,0,0,0,0,0,0,0,0,0,0,0,0,0,0,0
1409,Madhya Pradesh,2009,Open Jail,0,0,0,0,0,0,0,0,0,0,0,0,0,0,0
1410,Madhya Pradesh,2009,Special Jail,0,0,0,0,0,0,0,0,0,0,0,0,0,0,0
1411,Madhya Pradesh,2009,Others,0,0,0,0,0,0,0,0,0,0,0,0,0,0,0
1412,Madhya Pradesh,2009,Total,14967,400,15367,16780,531,17311,51,0,51,77,0,77,31875,931,32806
1413,Madhya Pradesh,2010,Central Jail,11106,288,11394,4127,205,4332,86,0,86,31,0,31,15350,493,15843
1414,Madhya Pradesh,2010,District Jail,1989,110,2099,4589,289,4878,0,0,0,64,9,73,6642,408,7050
1415,Madhya Pradesh,2010,Sub_Jail,1050,14,1064,7232,80,7312,0,0,0,27,0,27,8309,94,8403
1416,Madhya Pradesh,2010,Women Jail,0,0,0,0,0,0,0,0,0,0,0,0,0,0,0
1417,Madhya Pradesh,2010,Borstal School,0,0,0,0,0,0,0,0,0,0,0,0,0,0,0
1418,Madhya Pradesh,2010,Open Jail,22,0,22,0,0,0,0,0,0,0,0,0,22,0,22
1419,Madhya Pradesh,2010,Special Jail,0,0,0,0,0,0,0,0,0,0,0,0,0,0,0
1420,Madhya Pradesh,2010,Others,0,0,0,0,0,0,0,0,0,0,0,0,0,0,0
1421,Madhya Pradesh,2010,Total,14167,412,14579,15948,574,16522,86,0,86,122,9,131,30323,995,31318
1422,Madhya Pradesh,2011,Central Jail,11544,304,11848,4299,235,4534,130,0,130,35,0,35,16008,539,16547
1423,Madhya Pradesh,2011,District Jail,2901,138,3039,4540,293,4833,2,0,2,51,1,52,7494,432,7926
1424,Madhya Pradesh,2011,Sub_Jail,1033,12,1045,7232,102,7334,0,0,0,40,0,40,8305,114,8419
1425,Madhya Pradesh,2011,Women Jail,0,0,0,0,0,0,0,0,0,0,0,0,0,0,0
1426,Madhya Pradesh,2011,Borstal School,0,0,0,0,0,0,0,0,0,0,0,0,0,0,0
1427,Madhya Pradesh,2011,Open Jail,24,0,24,0,0,0,0,0,0,0,0,0,24,0,24
1428,Madhya Pradesh,2011,Special Jail,0,0,0,0,0,0,0,0,0,0,0,0,0,0,0
1429,Madhya Pradesh,2011,Others,0,0,0,0,0,0,0,0,0,0,0,0,0,0,0
1430,Madhya Pradesh,2011,Total,15502,454,15956,16071,630,16701,132,0,132,126,1,127,31831,1085,32916
1431,Madhya Pradesh,2012,Central Jail,11575,326,11901,4212,229,4441,138,1,139,9,0,9,15934,556,16490
1432,Madhya Pradesh,2012,District Jail,3072,149,3221,5591,370,5961,0,0,0,47,0,47,8710,519,9229
1433,Madhya Pradesh,2012,Sub_Jail,959,19,978,7130,87,7217,0,0,0,20,0,20,8109,106,8215
1434,Madhya Pradesh,2012,Women Jail,0,0,0,0,0,0,0,0,0,0,0,0,0,0,0
1435,Madhya Pradesh,2012,Borstal School,0,0,0,0,0,0,0,0,0,0,0,0,0,0,0
1436,Madhya Pradesh,2012,Open Jail,25,0,25,0,0,0,0,0,0,0,0,0,25,0,25
1437,Madhya Pradesh,2012,Special Jail,0,0,0,0,0,0,0,0,0,0,0,0,0,0,0
1438,Madhya Pradesh,2012,Others,0,0,0,0,0,0,0,0,0,0,0,0,0,0,0
1439,Madhya Pradesh,2012,Total,15631,494,16125,16933,686,17619,138,1,139,76,0,76,32778,1181,33959
1440,Maharashtra,2001,Central Jail,5379,265,5644,9250,290,9540,322,1,323,0,0,0,14951,556,15507
1441,Maharashtra,2001,District Jail,656,11,667,5505,291,5796,8,0,8,4,0,4,6173,302,6475
1442,Maharashtra,2001,Sub_Jail,0,0,0,0,0,0,0,0,0,0,0,0,0,0,0
1443,Maharashtra,2001,Women Jail,0,0,0,0,0,0,0,0,0,0,0,0,0,0,0
1444,Maharashtra,2001,Borstal School,0,0,0,0,0,0,34,0,34,0,0,0,34,0,34
1445,Maharashtra,2001,Open Jail,357,0,357,0,0,0,0,0,0,0,0,0,357,0,357
1446,Maharashtra,2001,Special Jail,20,1,21,108,2,110,0,0,0,0,0,0,128,3,131
1447,Maharashtra,2001,Others,21,2,23,0,0,0,0,0,0,0,0,0,21,2,23
1448,Maharashtra,2001,Total,6433,279,6712,14863,583,15446,364,1,365,4,0,4,21664,863,22527
1449,Maharashtra,2002,Central Jail,5825,298,6123,8287,297,8584,279,8,287,0,0,0,14391,603,14994
1450,Maharashtra,2002,District Jail,649,11,660,5492,348,5840,2,0,2,0,0,0,6143,359,6502
1451,Maharashtra,2002,Sub_Jail,0,0,0,0,0,0,0,0,0,0,0,0,0,0,0
1452,Maharashtra,2002,Women Jail,0,0,0,0,0,0,0,0,0,0,0,0,0,0,0
1453,Maharashtra,2002,Borstal School,0,0,0,0,0,0,18,0,18,0,0,0,18,0,18
1454,Maharashtra,2002,Open Jail,369,0,369,0,0,0,0,0,0,0,0,0,369,0,369
1455,Maharashtra,2002,Special Jail,24,0,24,90,3,93,0,0,0,0,0,0,114,3,117
1456,Maharashtra,2002,Others,20,2,22,0,0,0,0,0,0,0,0,0,20,2,22
1457,Maharashtra,2002,Total,6887,311,7198,13869,648,14517,299,8,307,0,0,0,21055,967,22022
1458,Maharashtra,2003,Central Jail,6565,360,6925,8984,129,9113,188,1,189,0,0,0,15737,490,16227
1459,Maharashtra,2003,District Jail,830,14,844,5688,378,6066,0,0,0,4,0,4,6522,392,6914
1460,Maharashtra,2003,Sub_Jail,0,0,0,0,0,0,0,0,0,0,0,0,0,0,0
1461,Maharashtra,2003,Women Jail,0,14,14,0,220,220,0,0,0,0,0,0,0,234,234
1462,Maharashtra,2003,Borstal School,0,0,0,0,0,0,0,0,0,17,0,17,17,0,17
1463,Maharashtra,2003,Open Jail,390,0,390,0,0,0,0,0,0,0,0,0,390,0,390
1464,Maharashtra,2003,Special Jail,24,0,24,104,1,105,0,0,0,0,0,0,128,1,129
1465,Maharashtra,2003,Others,16,2,18,0,0,0,0,0,0,0,0,0,16,2,18
1466,Maharashtra,2003,Total,7825,390,8215,14776,728,15504,188,1,189,21,0,21,22810,1119,23929
1467,Maharashtra,2004,Central Jail,7159,443,7602,9472,141,9613,165,0,165,1,0,1,16797,584,17381
1468,Maharashtra,2004,District Jail,837,25,862,5434,371,5805,5,0,5,7,0,7,6283,396,6679
1469,Maharashtra,2004,Sub_Jail,0,0,0,0,0,0,0,0,0,0,0,0,0,0,0
1470,Maharashtra,2004,Women Jail,0,15,15,0,259,259,0,0,0,0,0,0,0,274,274
1471,Maharashtra,2004,Borstal School,0,0,0,0,0,0,0,0,0,29,0,29,29,0,29
1472,Maharashtra,2004,Open Jail,418,0,418,0,0,0,0,0,0,0,0,0,418,0,418
1473,Maharashtra,2004,Special Jail,20,0,20,106,1,107,0,0,0,0,0,0,126,1,127
1474,Maharashtra,2004,Others,13,1,14,0,0,0,0,0,0,0,0,0,13,1,14
1475,Maharashtra,2004,Total,8447,484,8931,15012,772,15784,170,0,170,37,0,37,23666,1256,24922
1476,Maharashtra,2005,Central Jail,7225,428,7653,9383,173,9556,234,1,235,0,0,0,16842,602,17444
1477,Maharashtra,2005,District Jail,887,18,905,5615,359,5974,0,0,0,0,0,0,6502,377,6879
1478,Maharashtra,2005,Sub_Jail,0,0,0,0,0,0,0,0,0,0,0,0,0,0,0
1479,Maharashtra,2005,Women Jail,0,12,12,0,326,326,0,0,0,0,0,0,0,338,338
1480,Maharashtra,2005,Borstal School,0,0,0,0,0,0,0,0,0,21,0,21,21,0,21
1481,Maharashtra,2005,Open Jail,559,0,559,0,0,0,0,0,0,0,0,0,559,0,559
1482,Maharashtra,2005,Special Jail,85,1,86,86,4,90,0,0,0,0,0,0,171,5,176
1483,Maharashtra,2005,Others,10,4,14,0,0,0,0,0,0,0,0,0,10,4,14
1484,Maharashtra,2005,Total,8766,463,9229,15084,862,15946,234,1,235,21,0,21,24105,1326,25431
1485,Maharashtra,2006,Central Jail,7213,385,7598,9405,192,9597,242,1,243,0,0,0,16860,578,17438
1486,Maharashtra,2006,District Jail,741,23,764,5776,361,6137,2,0,2,1,0,1,6520,384,6904
1487,Maharashtra,2006,Sub_Jail,7,0,7,148,9,157,0,0,0,0,0,0,155,9,164
1488,Maharashtra,2006,Women Jail,0,36,36,0,345,345,0,0,0,0,0,0,0,381,381
1489,Maharashtra,2006,Borstal School,0,0,0,0,0,0,29,0,29,0,0,0,29,0,29
1490,Maharashtra,2006,Open Jail,642,0,642,0,0,0,0,0,0,0,0,0,642,0,642
1491,Maharashtra,2006,Special Jail,71,1,72,125,4,129,0,0,0,0,0,0,196,5,201
1492,Maharashtra,2006,Others,26,4,30,0,0,0,0,0,0,0,0,0,26,4,30
1493,Maharashtra,2006,Total,8700,449,9149,15454,911,16365,273,1,274,1,0,1,24428,1361,25789
1494,Maharashtra,2007,Central Jail,7360,449,7809,9314,191,9505,112,1,113,0,0,0,16786,641,17427
1495,Maharashtra,2007,District Jail,649,32,681,6130,442,6572,4,0,4,0,0,0,6783,474,7257
1496,Maharashtra,2007,Sub_Jail,4,0,4,121,9,130,0,0,0,0,0,0,125,9,134
1497,Maharashtra,2007,Women Jail,0,26,26,0,193,193,0,0,0,0,0,0,0,219,219
1498,Maharashtra,2007,Borstal School,0,0,0,0,0,0,35,0,35,0,0,0,35,0,35
1499,Maharashtra,2007,Open Jail,624,0,624,0,0,0,0,0,0,0,0,0,624,0,624
1500,Maharashtra,2007,Special Jail,35,0,35,131,6,137,0,0,0,0,0,0,166,6,172
1501,Maharashtra,2007,Others,20,4,24,0,0,0,0,0,0,0,0,0,20,4,24
1502,Maharashtra,2007,Total,8692,511,9203,15696,841,16537,151,1,152,0,0,0,24539,1353,25892
1503,Maharashtra,2008,Central Jail,7501,466,7967,9604,193,9797,66,2,68,0,0,0,17171,661,17832
1504,Maharashtra,2008,District Jail,547,12,559,5781,434,6215,3,0,3,0,0,0,6331,446,6777
1505,Maharashtra,2008,Sub_Jail,0,0,0,114,9,123,0,0,0,0,0,0,114,9,123
1506,Maharashtra,2008,Women Jail,0,18,18,0,296,296,0,0,0,0,0,0,0,314,314
1507,Maharashtra,2008,Borstal School,0,0,0,0,0,0,42,0,42,0,0,0,42,0,42
1508,Maharashtra,2008,Open Jail,584,0,584,0,0,0,0,0,0,0,0,0,584,0,584
1509,Maharashtra,2008,Special Jail,26,0,26,119,4,123,0,0,0,0,0,0,145,4,149
1510,Maharashtra,2008,Others,7,3,10,0,0,0,0,0,0,0,0,0,7,3,10
1511,Maharashtra,2008,Total,8665,499,9164,15618,936,16554,111,2,113,0,0,0,24394,1437,25831
1512,Maharashtra,2009,Central Jail,6879,471,7350,9608,165,9773,33,0,33,0,0,0,16520,636,17156
1513,Maharashtra,2009,District Jail,463,6,469,5293,448,5741,0,0,0,0,0,0,5756,454,6210
1514,Maharashtra,2009,Sub_Jail,4,0,4,251,12,263,0,0,0,0,0,0,255,12,267
1515,Maharashtra,2009,Women Jail,0,49,49,0,323,323,0,0,0,0,0,0,0,372,372
1516,Maharashtra,2009,Borstal School,0,0,0,0,0,0,49,0,49,0,0,0,49,0,49
1517,Maharashtra,2009,Open Jail,713,0,713,0,0,0,0,0,0,0,0,0,713,0,713
1518,Maharashtra,2009,Special Jail,16,0,16,75,5,80,0,0,0,0,0,0,91,5,96
1519,Maharashtra,2009,Others,18,3,21,0,0,0,0,0,0,0,0,0,18,3,21
1520,Maharashtra,2009,Total,8093,529,8622,15227,953,16180,82,0,82,0,0,0,23402,1482,24884
1521,Maharashtra,2010,Central Jail,6481,392,6873,9770,194,9964,34,1,35,0,0,0,16285,587,16872
1522,Maharashtra,2010,District Jail,414,4,418,5175,389,5564,1,0,1,0,0,0,5590,393,5983
1523,Maharashtra,2010,Sub_Jail,10,0,10,201,6,207,0,0,0,0,0,0,211,6,217
1524,Maharashtra,2010,Women Jail,0,5,5,0,253,253,0,1,1,0,0,0,0,259,259
1525,Maharashtra,2010,Borstal School,0,0,0,0,0,0,40,0,40,0,0,0,40,0,40
1526,Maharashtra,2010,Open Jail,771,46,817,0,0,0,0,0,0,0,0,0,771,46,817
1527,Maharashtra,2010,Special Jail,4,0,4,73,4,77,0,0,0,0,0,0,77,4,81
1528,Maharashtra,2010,Others,10,2,12,0,0,0,0,0,0,0,0,0,10,2,12
1529,Maharashtra,2010,Total,7690,449,8139,15219,846,16065,75,2,77,0,0,0,22984,1297,24281
1530,Maharashtra,2011,Central Jail,6248,383,6631,9834,196,10030,36,0,36,0,0,0,16118,579,16697
1531,Maharashtra,2011,District Jail,474,10,484,5207,482,5689,1,0,1,0,0,0,5682,492,6174
1532,Maharashtra,2011,Sub_Jail,0,0,0,44,3,47,0,0,0,0,0,0,44,3,47
1533,Maharashtra,2011,Women Jail,0,25,25,0,231,231,0,0,0,0,0,0,0,256,256
1534,Maharashtra,2011,Borstal School,0,0,0,0,0,0,29,0,29,0,0,0,29,0,29
1535,Maharashtra,2011,Open Jail,741,41,782,0,0,0,0,0,0,0,0,0,741,41,782
1536,Maharashtra,2011,Special Jail,9,0,9,64,3,67,0,0,0,0,0,0,73,3,76
1537,Maharashtra,2011,Others,19,2,21,0,0,0,0,0,0,0,0,0,19,2,21
1538,Maharashtra,2011,Total,7491,461,7952,15149,915,16064,66,0,66,0,0,0,22706,1376,24082
1539,Maharashtra,2012,Central Jail,6484,375,6859,9970,140,10110,39,0,39,0,0,0,16493,515,17008
1540,Maharashtra,2012,District Jail,402,47,449,5456,462,5918,3,0,3,0,0,0,5861,509,6370
1541,Maharashtra,2012,Sub_Jail,0,0,0,46,0,46,0,0,0,0,0,0,46,0,46
1542,Maharashtra,2012,Women Jail,0,4,4,0,277,277,0,0,0,0,0,0,0,281,281
1543,Maharashtra,2012,Borstal School,0,0,0,0,0,0,0,0,0,15,0,15,15,0,15
1544,Maharashtra,2012,Open Jail,660,29,689,0,0,0,0,0,0,0,0,0,660,29,689
1545,Maharashtra,2012,Special Jail,6,1,7,73,2,75,0,0,0,0,0,0,79,3,82
1546,Maharashtra,2012,Others,17,1,18,0,0,0,0,0,0,0,0,0,17,1,18
1547,Maharashtra,2012,Total,7569,457,8026,15545,881,16426,42,0,42,15,0,15,23171,1338,24509
1548,Manipur,2001,Central Jail,22,0,22,315,13,328,85,11,96,0,0,0,422,24,446
1549,Manipur,2001,District Jail,0,0,0,16,0,16,0,0,0,0,0,0,16,0,16
1550,Manipur,2001,Sub_Jail,0,0,0,0,0,0,0,0,0,0,0,0,0,0,0
1551,Manipur,2001,Women Jail,0,0,0,0,0,0,0,0,0,0,0,0,0,0,0
1552,Manipur,2001,Borstal School,0,0,0,0,0,0,0,0,0,0,0,0,0,0,0
1553,Manipur,2001,Open Jail,0,0,0,0,0,0,0,0,0,0,0,0,0,0,0
1554,Manipur,2001,Special Jail,0,0,0,0,0,0,0,0,0,0,0,0,0,0,0
1555,Manipur,2001,Others,0,0,0,0,0,0,0,0,0,0,0,0,0,0,0
1556,Manipur,2001,Total,22,0,22,331,13,344,85,11,96,0,0,0,438,24,462
1557,Manipur,2002,Central Jail,36,1,37,332,21,353,113,6,119,0,0,0,481,28,509
1558,Manipur,2002,District Jail,0,0,0,7,0,7,0,0,0,0,0,0,7,0,7
1559,Manipur,2002,Sub_Jail,0,0,0,0,0,0,0,0,0,0,0,0,0,0,0
1560,Manipur,2002,Women Jail,0,0,0,0,0,0,0,0,0,0,0,0,0,0,0
1561,Manipur,2002,Borstal School,0,0,0,0,0,0,0,0,0,0,0,0,0,0,0
1562,Manipur,2002,Open Jail,0,0,0,0,0,0,0,0,0,0,0,0,0,0,0
1563,Manipur,2002,Special Jail,0,0,0,0,0,0,0,0,0,0,0,0,0,0,0
1564,Manipur,2002,Others,0,0,0,0,0,0,0,0,0,0,0,0,0,0,0
1565,Manipur,2002,Total,36,1,37,339,21,360,113,6,119,0,0,0,488,28,516
1566,Manipur,2003,Central Jail,32,1,33,338,18,356,130,8,138,0,0,0,500,27,527
1567,Manipur,2003,District Jail,0,0,0,5,0,5,0,0,0,0,0,0,5,0,5
1568,Manipur,2003,Sub_Jail,0,0,0,0,0,0,0,0,0,0,0,0,0,0,0
1569,Manipur,2003,Women Jail,0,0,0,0,0,0,0,0,0,0,0,0,0,0,0
1570,Manipur,2003,Borstal School,0,0,0,0,0,0,0,0,0,0,0,0,0,0,0
1571,Manipur,2003,Open Jail,0,0,0,0,0,0,0,0,0,0,0,0,0,0,0
1572,Manipur,2003,Special Jail,0,0,0,0,0,0,0,0,0,0,0,0,0,0,0
1573,Manipur,2003,Others,0,0,0,0,0,0,0,0,0,0,0,0,0,0,0
1574,Manipur,2003,Total,32,1,33,343,18,361,130,8,138,0,0,0,505,27,532
1575,Manipur,2004,Central Jail,32,0,32,338,21,359,72,2,74,0,0,0,442,23,465
1576,Manipur,2004,District Jail,0,0,0,0,0,0,0,0,0,0,0,0,0,0,0
1577,Manipur,2004,Sub_Jail,0,0,0,0,0,0,0,0,0,0,0,0,0,0,0
1578,Manipur,2004,Women Jail,0,0,0,0,0,0,0,0,0,0,0,0,0,0,0
1579,Manipur,2004,Borstal School,0,0,0,0,0,0,0,0,0,0,0,0,0,0,0
1580,Manipur,2004,Open Jail,0,0,0,0,0,0,0,0,0,0,0,0,0,0,0
1581,Manipur,2004,Special Jail,0,0,0,0,0,0,0,0,0,0,0,0,0,0,0
1582,Manipur,2004,Others,0,0,0,0,0,0,0,0,0,0,0,0,0,0,0
1583,Manipur,2004,Total,32,0,32,338,21,359,72,2,74,0,0,0,442,23,465
1584,Manipur,2005,Central Jail,31,0,31,376,19,395,96,7,103,0,0,0,503,26,529
1585,Manipur,2005,District Jail,0,0,0,0,0,0,0,0,0,0,0,0,0,0,0
1586,Manipur,2005,Sub_Jail,0,0,0,0,0,0,0,0,0,0,0,0,0,0,0
1587,Manipur,2005,Women Jail,0,0,0,0,0,0,0,0,0,0,0,0,0,0,0
1588,Manipur,2005,Borstal School,0,0,0,0,0,0,0,0,0,0,0,0,0,0,0
1589,Manipur,2005,Open Jail,0,0,0,0,0,0,0,0,0,0,0,0,0,0,0
1590,Manipur,2005,Special Jail,0,0,0,0,0,0,0,0,0,0,0,0,0,0,0
1591,Manipur,2005,Others,0,0,0,0,0,0,0,0,0,0,0,0,0,0,0
1592,Manipur,2005,Total,31,0,31,376,19,395,96,7,103,0,0,0,503,26,529
1593,Manipur,2006,Central Jail,33,0,33,308,15,323,42,0,42,0,0,0,383,15,398
1594,Manipur,2006,District Jail,0,0,0,0,0,0,0,0,0,0,0,0,0,0,0
1595,Manipur,2006,Sub_Jail,0,0,0,0,0,0,0,0,0,0,0,0,0,0,0
1596,Manipur,2006,Women Jail,0,0,0,0,0,0,0,0,0,0,0,0,0,0,0
1597,Manipur,2006,Borstal School,0,0,0,0,0,0,0,0,0,0,0,0,0,0,0
1598,Manipur,2006,Open Jail,0,0,0,0,0,0,0,0,0,0,0,0,0,0,0
1599,Manipur,2006,Special Jail,0,0,0,0,0,0,0,0,0,0,0,0,0,0,0
1600,Manipur,2006,Others,0,0,0,0,0,0,0,0,0,0,0,0,0,0,0
1601,Manipur,2006,Total,33,0,33,308,15,323,42,0,42,0,0,0,383,15,398
1602,Manipur,2007,Central Jail,56,0,56,246,6,252,132,4,136,0,0,0,434,10,444
1603,Manipur,2007,District Jail,0,0,0,0,0,0,0,0,0,0,0,0,0,0,0
1604,Manipur,2007,Sub_Jail,0,0,0,0,0,0,0,0,0,0,0,0,0,0,0
1605,Manipur,2007,Women Jail,0,0,0,0,0,0,0,0,0,0,0,0,0,0,0
1606,Manipur,2007,Borstal School,0,0,0,0,0,0,0,0,0,0,0,0,0,0,0
1607,Manipur,2007,Open Jail,0,0,0,0,0,0,0,0,0,0,0,0,0,0,0
1608,Manipur,2007,Special Jail,0,0,0,0,0,0,0,0,0,0,0,0,0,0,0
1609,Manipur,2007,Others,0,0,0,0,0,0,0,0,0,0,0,0,0,0,0
1610,Manipur,2007,Total,56,0,56,246,6,252,132,4,136,0,0,0,434,10,444
1611,Manipur,2008,Central Jail,36,0,36,252,17,269,150,10,160,0,0,0,438,27,465
1612,Manipur,2008,District Jail,0,0,0,0,0,0,0,0,0,0,0,0,0,0,0
1613,Manipur,2008,Sub_Jail,0,0,0,0,0,0,0,0,0,0,0,0,0,0,0
1614,Manipur,2008,Women Jail,0,0,0,0,0,0,0,0,0,0,0,0,0,0,0
1615,Manipur,2008,Borstal School,0,0,0,0,0,0,0,0,0,0,0,0,0,0,0
1616,Manipur,2008,Open Jail,0,0,0,0,0,0,0,0,0,0,0,0,0,0,0
1617,Manipur,2008,Special Jail,0,0,0,0,0,0,0,0,0,0,0,0,0,0,0
1618,Manipur,2008,Others,0,0,0,0,0,0,0,0,0,0,0,0,0,0,0
1619,Manipur,2008,Total,36,0,36,252,17,269,150,10,160,0,0,0,438,27,465
1620,Manipur,2009,Central Jail,34,0,34,323,32,355,127,16,143,0,0,0,484,48,532
1621,Manipur,2009,District Jail,0,0,0,0,0,0,0,0,0,0,0,0,0,0,0
1622,Manipur,2009,Sub_Jail,0,0,0,0,0,0,0,0,0,0,0,0,0,0,0
1623,Manipur,2009,Women Jail,0,0,0,0,0,0,0,0,0,0,0,0,0,0,0
1624,Manipur,2009,Borstal School,0,0,0,0,0,0,0,0,0,0,0,0,0,0,0
1625,Manipur,2009,Open Jail,0,0,0,0,0,0,0,0,0,0,0,0,0,0,0
1626,Manipur,2009,Special Jail,0,0,0,0,0,0,0,0,0,0,0,0,0,0,0
1627,Manipur,2009,Others,0,0,0,0,0,0,0,0,0,0,0,0,0,0,0
1628,Manipur,2009,Total,34,0,34,323,32,355,127,16,143,0,0,0,484,48,532
1629,Manipur,2010,Central Jail,31,1,32,363,10,373,185,28,213,0,0,0,579,39,618
1630,Manipur,2010,District Jail,0,0,0,0,0,0,0,0,0,0,0,0,0,0,0
1631,Manipur,2010,Sub_Jail,0,0,0,0,0,0,0,0,0,0,0,0,0,0,0
1632,Manipur,2010,Women Jail,0,0,0,0,0,0,0,0,0,0,0,0,0,0,0
1633,Manipur,2010,Borstal School,0,0,0,0,0,0,0,0,0,0,0,0,0,0,0
1634,Manipur,2010,Open Jail,0,0,0,0,0,0,0,0,0,0,0,0,0,0,0
1635,Manipur,2010,Special Jail,0,0,0,0,0,0,0,0,0,0,0,0,0,0,0
1636,Manipur,2010,Others,0,0,0,0,0,0,0,0,0,0,0,0,0,0,0
1637,Manipur,2010,Total,31,1,32,363,10,373,185,28,213,0,0,0,579,39,618
1638,Manipur,2011,Central Jail,31,1,32,428,26,454,149,12,161,0,0,0,608,39,647
1639,Manipur,2011,District Jail,0,0,0,0,0,0,0,0,0,0,0,0,0,0,0
1640,Manipur,2011,Sub_Jail,0,0,0,0,0,0,0,0,0,0,0,0,0,0,0
1641,Manipur,2011,Women Jail,0,0,0,0,0,0,0,0,0,0,0,0,0,0,0
1642,Manipur,2011,Borstal School,0,0,0,0,0,0,0,0,0,0,0,0,0,0,0
1643,Manipur,2011,Open Jail,0,0,0,0,0,0,0,0,0,0,0,0,0,0,0
1644,Manipur,2011,Special Jail,0,0,0,0,0,0,0,0,0,0,0,0,0,0,0
1645,Manipur,2011,Others,0,0,0,0,0,0,0,0,0,0,0,0,0,0,0
1646,Manipur,2011,Total,31,1,32,428,26,454,149,12,161,0,0,0,608,39,647
1647,Manipur,2012,Central Jail,63,1,64,506,21,527,121,11,132,0,0,0,690,33,723
1648,Manipur,2012,District Jail,0,0,0,0,0,0,0,0,0,0,0,0,0,0,0
1649,Manipur,2012,Sub_Jail,0,0,0,0,0,0,0,0,0,0,0,0,0,0,0
1650,Manipur,2012,Women Jail,0,0,0,0,0,0,0,0,0,0,0,0,0,0,0
1651,Manipur,2012,Borstal School,0,0,0,0,0,0,0,0,0,0,0,0,0,0,0
1652,Manipur,2012,Open Jail,0,0,0,0,0,0,0,0,0,0,0,0,0,0,0
1653,Manipur,2012,Special Jail,0,0,0,0,0,0,0,0,0,0,0,0,0,0,0
1654,Manipur,2012,Others,0,0,0,0,0,0,0,0,0,0,0,0,0,0,0
1655,Manipur,2012,Total,63,1,64,506,21,527,121,11,132,0,0,0,690,33,723
1656,Meghalaya,2001,Central Jail,0,0,0,0,0,0,0,0,0,0,0,0,0,0,0
1657,Meghalaya,2001,District Jail,14,0,14,497,8,505,7,0,7,0,0,0,518,8,526
1658,Meghalaya,2001,Sub_Jail,0,0,0,0,0,0,0,0,0,0,0,0,0,0,0
1659,Meghalaya,2001,Women Jail,0,0,0,0,0,0,0,0,0,0,0,0,0,0,0
1660,Meghalaya,2001,Borstal School,0,0,0,0,0,0,0,0,0,0,0,0,0,0,0
1661,Meghalaya,2001,Open Jail,0,0,0,0,0,0,0,0,0,0,0,0,0,0,0
1662,Meghalaya,2001,Special Jail,0,0,0,0,0,0,0,0,0,0,0,0,0,0,0
1663,Meghalaya,2001,Others,0,0,0,0,0,0,0,0,0,0,0,0,0,0,0
1664,Meghalaya,2001,Total,14,0,14,497,8,505,7,0,7,0,0,0,518,8,526
1665,Meghalaya,2002,Central Jail,0,0,0,0,0,0,0,0,0,0,0,0,0,0,0
1666,Meghalaya,2002,District Jail,20,0,20,495,11,506,6,0,6,0,0,0,521,11,532
1667,Meghalaya,2002,Sub_Jail,0,0,0,0,0,0,0,0,0,0,0,0,0,0,0
1668,Meghalaya,2002,Women Jail,0,0,0,0,0,0,0,0,0,0,0,0,0,0,0
1669,Meghalaya,2002,Borstal School,0,0,0,0,0,0,0,0,0,0,0,0,0,0,0
1670,Meghalaya,2002,Open Jail,0,0,0,0,0,0,0,0,0,0,0,0,0,0,0
1671,Meghalaya,2002,Special Jail,0,0,0,0,0,0,0,0,0,0,0,0,0,0,0
1672,Meghalaya,2002,Others,0,0,0,0,0,0,0,0,0,0,0,0,0,0,0
1673,Meghalaya,2002,Total,20,0,20,495,11,506,6,0,6,0,0,0,521,11,532
1674,Meghalaya,2003,Central Jail,0,0,0,0,0,0,0,0,0,0,0,0,0,0,0
1675,Meghalaya,2003,District Jail,39,0,39,500,8,508,8,0,8,0,0,0,547,8,555
1676,Meghalaya,2003,Sub_Jail,0,0,0,0,0,0,0,0,0,0,0,0,0,0,0
1677,Meghalaya,2003,Women Jail,0,0,0,0,0,0,0,0,0,0,0,0,0,0,0
1678,Meghalaya,2003,Borstal School,0,0,0,0,0,0,0,0,0,0,0,0,0,0,0
1679,Meghalaya,2003,Open Jail,0,0,0,0,0,0,0,0,0,0,0,0,0,0,0
1680,Meghalaya,2003,Special Jail,0,0,0,0,0,0,0,0,0,0,0,0,0,0,0
1681,Meghalaya,2003,Others,0,0,0,0,0,0,0,0,0,0,0,0,0,0,0
1682,Meghalaya,2003,Total,39,0,39,500,8,508,8,0,8,0,0,0,547,8,555
1683,Meghalaya,2004,Central Jail,0,0,0,0,0,0,0,0,0,0,0,0,0,0,0
1684,Meghalaya,2004,District Jail,41,0,41,420,10,430,22,0,22,0,0,0,483,10,493
1685,Meghalaya,2004,Sub_Jail,0,0,0,0,0,0,0,0,0,0,0,0,0,0,0
1686,Meghalaya,2004,Women Jail,0,0,0,0,0,0,0,0,0,0,0,0,0,0,0
1687,Meghalaya,2004,Borstal School,0,0,0,0,0,0,0,0,0,0,0,0,0,0,0
1688,Meghalaya,2004,Open Jail,0,0,0,0,0,0,0,0,0,0,0,0,0,0,0
1689,Meghalaya,2004,Special Jail,0,0,0,0,0,0,0,0,0,0,0,0,0,0,0
1690,Meghalaya,2004,Others,0,0,0,0,0,0,0,0,0,0,0,0,0,0,0
1691,Meghalaya,2004,Total,41,0,41,420,10,430,22,0,22,0,0,0,483,10,493
1692,Meghalaya,2005,Central Jail,0,0,0,0,0,0,0,0,0,0,0,0,0,0,0
1693,Meghalaya,2005,District Jail,42,4,46,478,9,487,22,0,22,0,0,0,542,13,555
1694,Meghalaya,2005,Sub_Jail,0,0,0,0,0,0,0,0,0,0,0,0,0,0,0
1695,Meghalaya,2005,Women Jail,0,0,0,0,0,0,0,0,0,0,0,0,0,0,0
1696,Meghalaya,2005,Borstal School,0,0,0,0,0,0,0,0,0,0,0,0,0,0,0
1697,Meghalaya,2005,Open Jail,0,0,0,0,0,0,0,0,0,0,0,0,0,0,0
1698,Meghalaya,2005,Special Jail,0,0,0,0,0,0,0,0,0,0,0,0,0,0,0
1699,Meghalaya,2005,Others,0,0,0,0,0,0,0,0,0,0,0,0,0,0,0
1700,Meghalaya,2005,Total,42,4,46,478,9,487,22,0,22,0,0,0,542,13,555
1701,Meghalaya,2006,Central Jail,0,0,0,0,0,0,0,0,0,0,0,0,0,0,0
1702,Meghalaya,2006,District Jail,56,2,58,532,7,539,24,0,24,0,0,0,612,9,621
1703,Meghalaya,2006,Sub_Jail,0,0,0,0,0,0,0,0,0,0,0,0,0,0,0
1704,Meghalaya,2006,Women Jail,0,0,0,0,0,0,0,0,0,0,0,0,0,0,0
1705,Meghalaya,2006,Borstal School,0,0,0,0,0,0,0,0,0,0,0,0,0,0,0
1706,Meghalaya,2006,Open Jail,0,0,0,0,0,0,0,0,0,0,0,0,0,0,0
1707,Meghalaya,2006,Special Jail,0,0,0,0,0,0,0,0,0,0,0,0,0,0,0
1708,Meghalaya,2006,Others,0,0,0,0,0,0,0,0,0,0,0,0,0,0,0
1709,Meghalaya,2006,Total,56,2,58,532,7,539,24,0,24,0,0,0,612,9,621
1710,Meghalaya,2007,Central Jail,0,0,0,0,0,0,0,0,0,0,0,0,0,0,0
1711,Meghalaya,2007,District Jail,70,2,72,553,4,557,36,0,36,0,0,0,659,6,665
1712,Meghalaya,2007,Sub_Jail,0,0,0,0,0,0,0,0,0,0,0,0,0,0,0
1713,Meghalaya,2007,Women Jail,0,0,0,0,0,0,0,0,0,0,0,0,0,0,0
1714,Meghalaya,2007,Borstal School,0,0,0,0,0,0,0,0,0,0,0,0,0,0,0
1715,Meghalaya,2007,Open Jail,0,0,0,0,0,0,0,0,0,0,0,0,0,0,0
1716,Meghalaya,2007,Special Jail,0,0,0,0,0,0,0,0,0,0,0,0,0,0,0
1717,Meghalaya,2007,Others,0,0,0,0,0,0,0,0,0,0,0,0,0,0,0
1718,Meghalaya,2007,Total,70,2,72,553,4,557,36,0,36,0,0,0,659,6,665
1719,Meghalaya,2008,Central Jail,0,0,0,0,0,0,0,0,0,0,0,0,0,0,0
1720,Meghalaya,2008,District Jail,90,2,92,476,4,480,47,0,47,0,0,0,613,6,619
1721,Meghalaya,2008,Sub_Jail,0,0,0,0,0,0,0,0,0,0,0,0,0,0,0
1722,Meghalaya,2008,Women Jail,0,0,0,0,0,0,0,0,0,0,0,0,0,0,0
1723,Meghalaya,2008,Borstal School,0,0,0,0,0,0,0,0,0,0,0,0,0,0,0
1724,Meghalaya,2008,Open Jail,0,0,0,0,0,0,0,0,0,0,0,0,0,0,0
1725,Meghalaya,2008,Special Jail,0,0,0,0,0,0,0,0,0,0,0,0,0,0,0
1726,Meghalaya,2008,Others,0,0,0,0,0,0,0,0,0,0,0,0,0,0,0
1727,Meghalaya,2008,Total,90,2,92,476,4,480,47,0,47,0,0,0,613,6,619
1728,Meghalaya,2009,Central Jail,0,0,0,0,0,0,0,0,0,0,0,0,0,0,0
1729,Meghalaya,2009,District Jail,97,1,98,513,7,520,38,0,38,0,0,0,648,8,656
1730,Meghalaya,2009,Sub_Jail,0,0,0,0,0,0,0,0,0,0,0,0,0,0,0
1731,Meghalaya,2009,Women Jail,0,0,0,0,0,0,0,0,0,0,0,0,0,0,0
1732,Meghalaya,2009,Borstal School,0,0,0,0,0,0,0,0,0,0,0,0,0,0,0
1733,Meghalaya,2009,Open Jail,0,0,0,0,0,0,0,0,0,0,0,0,0,0,0
1734,Meghalaya,2009,Special Jail,0,0,0,0,0,0,0,0,0,0,0,0,0,0,0
1735,Meghalaya,2009,Others,0,0,0,0,0,0,0,0,0,0,0,0,0,0,0
1736,Meghalaya,2009,Total,97,1,98,513,7,520,38,0,38,0,0,0,648,8,656
1737,Meghalaya,2010,Central Jail,0,0,0,0,0,0,0,0,0,0,0,0,0,0,0
1738,Meghalaya,2010,District Jail,70,0,70,507,6,513,43,0,43,0,0,0,620,6,626
1739,Meghalaya,2010,Sub_Jail,0,0,0,0,0,0,0,0,0,0,0,0,0,0,0
1740,Meghalaya,2010,Women Jail,0,0,0,0,0,0,0,0,0,0,0,0,0,0,0
1741,Meghalaya,2010,Borstal School,0,0,0,0,0,0,0,0,0,0,0,0,0,0,0
1742,Meghalaya,2010,Open Jail,0,0,0,0,0,0,0,0,0,0,0,0,0,0,0
1743,Meghalaya,2010,Special Jail,0,0,0,0,0,0,0,0,0,0,0,0,0,0,0
1744,Meghalaya,2010,Others,0,0,0,0,0,0,0,0,0,0,0,0,0,0,0
1745,Meghalaya,2010,Total,70,0,70,507,6,513,43,0,43,0,0,0,620,6,626
1746,Meghalaya,2011,Central Jail,0,0,0,0,0,0,0,0,0,0,0,0,0,0,0
1747,Meghalaya,2011,District Jail,65,0,65,466,12,478,27,0,27,0,0,0,558,12,570
1748,Meghalaya,2011,Sub_Jail,0,0,0,0,0,0,0,0,0,0,0,0,0,0,0
1749,Meghalaya,2011,Women Jail,0,0,0,0,0,0,0,0,0,0,0,0,0,0,0
1750,Meghalaya,2011,Borstal School,0,0,0,0,0,0,0,0,0,0,0,0,0,0,0
1751,Meghalaya,2011,Open Jail,0,0,0,0,0,0,0,0,0,0,0,0,0,0,0
1752,Meghalaya,2011,Special Jail,0,0,0,0,0,0,0,0,0,0,0,0,0,0,0
1753,Meghalaya,2011,Others,0,0,0,0,0,0,0,0,0,0,0,0,0,0,0
1754,Meghalaya,2011,Total,65,0,65,466,12,478,27,0,27,0,0,0,558,12,570
1755,Meghalaya,2012,Central Jail,0,0,0,0,0,0,0,0,0,0,0,0,0,0,0
1756,Meghalaya,2012,District Jail,70,0,70,593,12,605,21,0,21,0,0,0,684,12,696
1757,Meghalaya,2012,Sub_Jail,0,0,0,0,0,0,0,0,0,0,0,0,0,0,0
1758,Meghalaya,2012,Women Jail,0,0,0,0,0,0,0,0,0,0,0,0,0,0,0
1759,Meghalaya,2012,Borstal School,0,0,0,0,0,0,0,0,0,0,0,0,0,0,0
1760,Meghalaya,2012,Open Jail,0,0,0,0,0,0,0,0,0,0,0,0,0,0,0
1761,Meghalaya,2012,Special Jail,0,0,0,0,0,0,0,0,0,0,0,0,0,0,0
1762,Meghalaya,2012,Others,0,0,0,0,0,0,0,0,0,0,0,0,0,0,0
1763,Meghalaya,2012,Total,70,0,70,593,12,605,21,0,21,0,0,0,684,12,696
1764,Mizoram,2001,Central Jail,54,2,56,294,51,345,0,0,0,0,0,0,348,53,401
1765,Mizoram,2001,District Jail,89,9,98,338,21,359,0,0,0,0,0,0,427,30,457
1766,Mizoram,2001,Sub_Jail,0,0,0,0,0,0,0,0,0,0,0,0,0,0,0
1767,Mizoram,2001,Women Jail,0,0,0,0,0,0,0,0,0,0,0,0,0,0,0
1768,Mizoram,2001,Borstal School,0,0,0,0,0,0,0,0,0,0,0,0,0,0,0
1769,Mizoram,2001,Open Jail,0,0,0,0,0,0,0,0,0,0,0,0,0,0,0
1770,Mizoram,2001,Special Jail,0,0,0,0,0,0,0,0,0,0,0,0,0,0,0
1771,Mizoram,2001,Others,0,0,0,0,0,0,0,0,0,0,0,0,0,0,0
1772,Mizoram,2001,Total,143,11,154,632,72,704,0,0,0,0,0,0,775,83,858
1773,Mizoram,2002,Central Jail,118,11,129,248,41,289,0,0,0,0,0,0,366,52,418
1774,Mizoram,2002,District Jail,138,10,148,268,24,292,0,0,0,0,0,0,406,34,440
1775,Mizoram,2002,Sub_Jail,0,0,0,0,0,0,0,0,0,0,0,0,0,0,0
1776,Mizoram,2002,Women Jail,0,0,0,0,0,0,0,0,0,0,0,0,0,0,0
1777,Mizoram,2002,Borstal School,0,0,0,0,0,0,0,0,0,0,0,0,0,0,0
1778,Mizoram,2002,Open Jail,0,0,0,0,0,0,0,0,0,0,0,0,0,0,0
1779,Mizoram,2002,Special Jail,0,0,0,0,0,0,0,0,0,0,0,0,0,0,0
1780,Mizoram,2002,Others,0,0,0,0,0,0,0,0,0,0,0,0,0,0,0
1781,Mizoram,2002,Total,256,21,277,516,65,581,0,0,0,0,0,0,772,86,858
1782,Mizoram,2003,Central Jail,61,1,62,250,30,280,0,0,0,0,0,0,311,31,342
1783,Mizoram,2003,District Jail,133,7,140,317,38,355,0,0,0,0,0,0,450,45,495
1784,Mizoram,2003,Sub_Jail,0,0,0,0,0,0,0,0,0,0,0,0,0,0,0
1785,Mizoram,2003,Women Jail,0,0,0,0,0,0,0,0,0,0,0,0,0,0,0
1786,Mizoram,2003,Borstal School,0,0,0,0,0,0,0,0,0,0,0,0,0,0,0
1787,Mizoram,2003,Open Jail,0,0,0,0,0,0,0,0,0,0,0,0,0,0,0
1788,Mizoram,2003,Special Jail,0,0,0,0,0,0,0,0,0,0,0,0,0,0,0
1789,Mizoram,2003,Others,0,0,0,0,0,0,0,0,0,0,0,0,0,0,0
1790,Mizoram,2003,Total,194,8,202,567,68,635,0,0,0,0,0,0,761,76,837
1791,Mizoram,2004,Central Jail,67,2,69,273,59,332,0,0,0,0,0,0,340,61,401
1792,Mizoram,2004,District Jail,141,7,148,383,27,410,0,0,0,0,0,0,524,34,558
1793,Mizoram,2004,Sub_Jail,0,0,0,0,0,0,0,0,0,0,0,0,0,0,0
1794,Mizoram,2004,Women Jail,0,0,0,0,0,0,0,0,0,0,0,0,0,0,0
1795,Mizoram,2004,Borstal School,0,0,0,0,0,0,0,0,0,0,0,0,0,0,0
1796,Mizoram,2004,Open Jail,0,0,0,0,0,0,0,0,0,0,0,0,0,0,0
1797,Mizoram,2004,Special Jail,0,0,0,0,0,0,0,0,0,0,0,0,0,0,0
1798,Mizoram,2004,Others,0,0,0,0,0,0,0,0,0,0,0,0,0,0,0
1799,Mizoram,2004,Total,208,9,217,656,86,742,0,0,0,0,0,0,864,95,959
1800,Mizoram,2005,Central Jail,64,3,67,194,17,211,0,0,0,0,0,0,258,20,278
1801,Mizoram,2005,District Jail,87,17,104,289,42,331,0,0,0,0,0,0,376,59,435
1802,Mizoram,2005,Sub_Jail,0,0,0,0,0,0,0,0,0,0,0,0,0,0,0
1803,Mizoram,2005,Women Jail,0,0,0,0,0,0,0,0,0,0,0,0,0,0,0
1804,Mizoram,2005,Borstal School,0,0,0,0,0,0,0,0,0,0,0,0,0,0,0
1805,Mizoram,2005,Open Jail,0,0,0,0,0,0,0,0,0,0,0,0,0,0,0
1806,Mizoram,2005,Special Jail,0,0,0,0,0,0,0,0,0,0,0,0,0,0,0
1807,Mizoram,2005,Others,0,0,0,0,0,0,0,0,0,0,0,0,0,0,0
1808,Mizoram,2005,Total,151,20,171,483,59,542,0,0,0,0,0,0,634,79,713
1809,Mizoram,2006,Central Jail,109,6,115,229,34,263,0,0,0,0,0,0,338,40,378
1810,Mizoram,2006,District Jail,87,11,98,224,29,253,0,0,0,0,0,0,311,40,351
1811,Mizoram,2006,Sub_Jail,0,0,0,0,0,0,0,0,0,0,0,0,0,0,0
1812,Mizoram,2006,Women Jail,0,0,0,0,0,0,0,0,0,0,0,0,0,0,0
1813,Mizoram,2006,Borstal School,0,0,0,0,0,0,0,0,0,0,0,0,0,0,0
1814,Mizoram,2006,Open Jail,0,0,0,0,0,0,0,0,0,0,0,0,0,0,0
1815,Mizoram,2006,Special Jail,0,0,0,0,0,0,0,0,0,0,0,0,0,0,0
1816,Mizoram,2006,Others,0,0,0,0,0,0,0,0,0,0,0,0,0,0,0
1817,Mizoram,2006,Total,196,17,213,453,63,516,0,0,0,0,0,0,649,80,729
1818,Mizoram,2007,Central Jail,148,11,159,296,50,346,0,0,0,0,0,0,444,61,505
1819,Mizoram,2007,District Jail,136,11,147,266,23,289,0,0,0,0,0,0,402,34,436
1820,Mizoram,2007,Sub_Jail,0,0,0,0,0,0,0,0,0,0,0,0,0,0,0
1821,Mizoram,2007,Women Jail,0,0,0,0,0,0,0,0,0,0,0,0,0,0,0
1822,Mizoram,2007,Borstal School,0,0,0,0,0,0,0,0,0,0,0,0,0,0,0
1823,Mizoram,2007,Open Jail,0,0,0,0,0,0,0,0,0,0,0,0,0,0,0
1824,Mizoram,2007,Special Jail,0,0,0,0,0,0,0,0,0,0,0,0,0,0,0
1825,Mizoram,2007,Others,0,0,0,0,0,0,0,0,0,0,0,0,0,0,0
1826,Mizoram,2007,Total,284,22,306,562,73,635,0,0,0,0,0,0,846,95,941
1827,Mizoram,2008,Central Jail,153,8,161,219,27,246,0,0,0,0,0,0,372,35,407
1828,Mizoram,2008,District Jail,161,7,168,195,20,215,0,0,0,0,0,0,356,27,383
1829,Mizoram,2008,Sub_Jail,0,0,0,0,0,0,0,0,0,0,0,0,0,0,0
1830,Mizoram,2008,Women Jail,0,0,0,0,0,0,0,0,0,0,0,0,0,0,0
1831,Mizoram,2008,Borstal School,0,0,0,0,0,0,0,0,0,0,0,0,0,0,0
1832,Mizoram,2008,Open Jail,0,0,0,0,0,0,0,0,0,0,0,0,0,0,0
1833,Mizoram,2008,Special Jail,0,0,0,0,0,0,0,0,0,0,0,0,0,0,0
1834,Mizoram,2008,Others,0,0,0,0,0,0,0,0,0,0,0,0,0,0,0
1835,Mizoram,2008,Total,314,15,329,414,47,461,0,0,0,0,0,0,728,62,790
1836,Mizoram,2009,Central Jail,197,5,202,204,27,231,0,0,0,0,0,0,401,32,433
1837,Mizoram,2009,District Jail,145,6,151,163,18,181,0,0,0,0,0,0,308,24,332
1838,Mizoram,2009,Sub_Jail,0,0,0,0,0,0,0,0,0,0,0,0,0,0,0
1839,Mizoram,2009,Women Jail,0,0,0,0,0,0,0,0,0,0,0,0,0,0,0
1840,Mizoram,2009,Borstal School,0,0,0,0,0,0,0,0,0,0,0,0,0,0,0
1841,Mizoram,2009,Open Jail,0,0,0,0,0,0,0,0,0,0,0,0,0,0,0
1842,Mizoram,2009,Special Jail,0,0,0,0,0,0,0,0,0,0,0,0,0,0,0
1843,Mizoram,2009,Others,0,0,0,0,0,0,0,0,0,0,0,0,0,0,0
1844,Mizoram,2009,Total,342,11,353,367,45,412,0,0,0,0,0,0,709,56,765
1845,Mizoram,2010,Central Jail,273,16,289,263,39,302,0,0,0,0,0,0,536,55,591
1846,Mizoram,2010,District Jail,157,5,162,218,21,239,0,0,0,0,0,0,375,26,401
1847,Mizoram,2010,Sub_Jail,0,0,0,0,0,0,0,0,0,0,0,0,0,0,0
1848,Mizoram,2010,Women Jail,0,0,0,0,0,0,0,0,0,0,0,0,0,0,0
1849,Mizoram,2010,Borstal School,0,0,0,0,0,0,0,0,0,0,0,0,0,0,0
1850,Mizoram,2010,Open Jail,0,0,0,0,0,0,0,0,0,0,0,0,0,0,0
1851,Mizoram,2010,Special Jail,0,0,0,0,0,0,0,0,0,0,0,0,0,0,0
1852,Mizoram,2010,Others,0,0,0,0,0,0,0,0,0,0,0,0,0,0,0
1853,Mizoram,2010,Total,430,21,451,481,60,541,0,0,0,0,0,0,911,81,992
1854,Mizoram,2011,Central Jail,210,17,227,231,32,263,0,0,0,0,0,0,441,49,490
1855,Mizoram,2011,District Jail,152,3,155,216,20,236,0,0,0,0,0,0,368,23,391
1856,Mizoram,2011,Sub_Jail,0,0,0,0,0,0,0,0,0,0,0,0,0,0,0
1857,Mizoram,2011,Women Jail,0,0,0,0,0,0,0,0,0,0,0,0,0,0,0
1858,Mizoram,2011,Borstal School,0,0,0,0,0,0,0,0,0,0,0,0,0,0,0
1859,Mizoram,2011,Open Jail,0,0,0,0,0,0,0,0,0,0,0,0,0,0,0
1860,Mizoram,2011,Special Jail,0,0,0,0,0,0,0,0,0,0,0,0,0,0,0
1861,Mizoram,2011,Others,0,0,0,0,0,0,0,0,0,0,0,0,0,0,0
1862,Mizoram,2011,Total,362,20,382,447,52,499,0,0,0,0,0,0,809,72,881
1863,Mizoram,2012,Central Jail,177,5,182,212,31,243,0,0,0,0,0,0,389,36,425
1864,Mizoram,2012,District Jail,133,4,137,263,22,285,0,0,0,0,0,0,396,26,422
1865,Mizoram,2012,Sub_Jail,0,0,0,0,0,0,0,0,0,0,0,0,0,0,0
1866,Mizoram,2012,Women Jail,0,0,0,0,0,0,0,0,0,0,0,0,0,0,0
1867,Mizoram,2012,Borstal School,0,0,0,0,0,0,0,0,0,0,0,0,0,0,0
1868,Mizoram,2012,Open Jail,0,0,0,0,0,0,0,0,0,0,0,0,0,0,0
1869,Mizoram,2012,Special Jail,0,0,0,0,0,0,0,0,0,0,0,0,0,0,0
1870,Mizoram,2012,Others,0,0,0,0,0,0,0,0,0,0,0,0,0,0,0
1871,Mizoram,2012,Total,310,9,319,475,53,528,0,0,0,0,0,0,785,62,847
1872,Nagaland,2001,Central Jail,40,0,40,225,0,225,52,0,52,0,0,0,317,0,317
1873,Nagaland,2001,District Jail,14,0,14,205,6,211,0,0,0,0,0,0,219,6,225
1874,Nagaland,2001,Sub_Jail,12,2,14,97,12,109,0,0,0,0,0,0,109,14,123
1875,Nagaland,2001,Women Jail,0,0,0,0,0,0,0,0,0,0,0,0,0,0,0
1876,Nagaland,2001,Borstal School,0,0,0,0,0,0,0,0,0,0,0,0,0,0,0
1877,Nagaland,2001,Open Jail,0,0,0,0,0,0,0,0,0,0,0,0,0,0,0
1878,Nagaland,2001,Special Jail,0,0,0,0,0,0,0,0,0,0,0,0,0,0,0
1879,Nagaland,2001,Others,0,0,0,0,0,0,0,0,0,0,0,0,0,0,0
1880,Nagaland,2001,Total,66,2,68,527,18,545,52,0,52,0,0,0,645,20,665
1881,Nagaland,2002,Central Jail,7,0,7,263,0,263,57,0,57,0,0,0,327,0,327
1882,Nagaland,2002,District Jail,13,0,13,183,5,188,0,0,0,0,0,0,196,5,201
1883,Nagaland,2002,Sub_Jail,9,1,10,87,6,93,0,0,0,0,0,0,96,7,103
1884,Nagaland,2002,Women Jail,0,0,0,0,0,0,0,0,0,0,0,0,0,0,0
1885,Nagaland,2002,Borstal School,0,0,0,0,0,0,0,0,0,0,0,0,0,0,0
1886,Nagaland,2002,Open Jail,0,0,0,0,0,0,0,0,0,0,0,0,0,0,0
1887,Nagaland,2002,Special Jail,0,0,0,0,0,0,0,0,0,0,0,0,0,0,0
1888,Nagaland,2002,Others,0,0,0,0,0,0,0,0,0,0,0,0,0,0,0
1889,Nagaland,2002,Total,29,1,30,533,11,544,57,0,57,0,0,0,619,12,631
1890,Nagaland,2003,Central Jail,70,0,70,121,0,121,72,0,72,0,0,0,263,0,263
1891,Nagaland,2003,District Jail,9,0,9,189,7,196,0,0,0,0,0,0,198,7,205
1892,Nagaland,2003,Sub_Jail,9,1,10,84,6,90,0,0,0,0,0,0,93,7,100
1893,Nagaland,2003,Women Jail,0,0,0,0,0,0,0,0,0,0,0,0,0,0,0
1894,Nagaland,2003,Borstal School,0,0,0,0,0,0,0,0,0,0,0,0,0,0,0
1895,Nagaland,2003,Open Jail,0,0,0,0,0,0,0,0,0,0,0,0,0,0,0
1896,Nagaland,2003,Special Jail,0,0,0,0,0,0,0,0,0,0,0,0,0,0,0
1897,Nagaland,2003,Others,0,0,0,0,0,0,0,0,0,0,0,0,0,0,0
1898,Nagaland,2003,Total,88,1,89,394,13,407,72,0,72,0,0,0,554,14,568
1899,Nagaland,2004,Central Jail,104,0,104,119,0,119,37,0,37,0,0,0,260,0,260
1900,Nagaland,2004,District Jail,16,0,16,140,10,150,0,0,0,0,0,0,156,10,166
1901,Nagaland,2004,Sub_Jail,40,1,41,115,6,121,1,0,1,0,0,0,156,7,163
1902,Nagaland,2004,Women Jail,0,0,0,0,0,0,0,0,0,0,0,0,0,0,0
1903,Nagaland,2004,Borstal School,0,0,0,0,0,0,0,0,0,0,0,0,0,0,0
1904,Nagaland,2004,Open Jail,0,0,0,0,0,0,0,0,0,0,0,0,0,0,0
1905,Nagaland,2004,Special Jail,0,0,0,0,0,0,0,0,0,0,0,0,0,0,0
1906,Nagaland,2004,Others,0,0,0,0,0,0,0,0,0,0,0,0,0,0,0
1907,Nagaland,2004,Total,160,1,161,374,16,390,38,0,38,0,0,0,572,17,589
1908,Nagaland,2005,Central Jail,85,0,85,166,0,166,24,0,24,0,0,0,275,0,275
1909,Nagaland,2005,District Jail,15,0,15,178,5,183,0,0,0,0,0,0,193,5,198
1910,Nagaland,2005,Sub_Jail,13,4,17,124,11,135,0,0,0,0,0,0,137,15,152
1911,Nagaland,2005,Women Jail,0,0,0,0,0,0,0,0,0,0,0,0,0,0,0
1912,Nagaland,2005,Borstal School,0,0,0,0,0,0,0,0,0,0,0,0,0,0,0
1913,Nagaland,2005,Open Jail,0,0,0,0,0,0,0,0,0,0,0,0,0,0,0
1914,Nagaland,2005,Special Jail,0,0,0,0,0,0,0,0,0,0,0,0,0,0,0
1915,Nagaland,2005,Others,0,0,0,0,0,0,0,0,0,0,0,0,0,0,0
1916,Nagaland,2005,Total,113,4,117,468,16,484,24,0,24,0,0,0,605,20,625
1917,Nagaland,2006,Central Jail,94,0,94,142,0,142,20,0,20,0,0,0,256,0,256
1918,Nagaland,2006,District Jail,15,0,15,158,5,163,0,0,0,0,0,0,173,5,178
1919,Nagaland,2006,Sub_Jail,18,6,24,198,14,212,1,3,4,0,0,0,217,23,240
1920,Nagaland,2006,Women Jail,0,0,0,0,0,0,0,0,0,0,0,0,0,0,0
1921,Nagaland,2006,Borstal School,0,0,0,0,0,0,0,0,0,0,0,0,0,0,0
1922,Nagaland,2006,Open Jail,0,0,0,0,0,0,0,0,0,0,0,0,0,0,0
1923,Nagaland,2006,Special Jail,0,0,0,0,0,0,0,0,0,0,0,0,0,0,0
1924,Nagaland,2006,Others,0,0,0,0,0,0,0,0,0,0,0,0,0,0,0
1925,Nagaland,2006,Total,127,6,133,498,19,517,21,3,24,0,0,0,646,28,674
1926,Nagaland,2007,Central Jail,71,0,71,123,0,123,5,0,5,0,0,0,199,0,199
1927,Nagaland,2007,District Jail,10,0,10,131,7,138,0,0,0,0,0,0,141,7,148
1928,Nagaland,2007,Sub_Jail,14,6,20,128,5,133,1,0,1,0,0,0,143,11,154
1929,Nagaland,2007,Women Jail,0,0,0,0,0,0,0,0,0,0,0,0,0,0,0
1930,Nagaland,2007,Borstal School,0,0,0,0,0,0,0,0,0,0,0,0,0,0,0
1931,Nagaland,2007,Open Jail,0,0,0,0,0,0,0,0,0,0,0,0,0,0,0
1932,Nagaland,2007,Special Jail,0,0,0,0,0,0,0,0,0,0,0,0,0,0,0
1933,Nagaland,2007,Others,0,0,0,0,0,0,0,0,0,0,0,0,0,0,0
1934,Nagaland,2007,Total,95,6,101,382,12,394,6,0,6,0,0,0,483,18,501
1935,Nagaland,2008,Central Jail,94,0,94,137,0,137,63,0,63,0,0,0,294,0,294
1936,Nagaland,2008,District Jail,35,1,36,101,2,103,0,0,0,0,0,0,136,3,139
1937,Nagaland,2008,Sub_Jail,25,5,30,148,8,156,0,0,0,0,0,0,173,13,186
1938,Nagaland,2008,Women Jail,0,0,0,0,0,0,0,0,0,0,0,0,0,0,0
1939,Nagaland,2008,Borstal School,0,0,0,0,0,0,0,0,0,0,0,0,0,0,0
1940,Nagaland,2008,Open Jail,0,0,0,0,0,0,0,0,0,0,0,0,0,0,0
1941,Nagaland,2008,Special Jail,0,0,0,0,0,0,0,0,0,0,0,0,0,0,0
1942,Nagaland,2008,Others,0,0,0,0,0,0,0,0,0,0,0,0,0,0,0
1943,Nagaland,2008,Total,154,6,160,386,10,396,63,0,63,0,0,0,603,16,619
1944,Nagaland,2009,Central Jail,95,0,95,146,0,146,42,0,42,0,0,0,283,0,283
1945,Nagaland,2009,District Jail,32,0,32,96,4,100,0,0,0,0,0,0,128,4,132
1946,Nagaland,2009,Sub_Jail,25,2,27,170,11,181,0,0,0,0,0,0,195,13,208
1947,Nagaland,2009,Women Jail,0,0,0,0,0,0,0,0,0,0,0,0,0,0,0
1948,Nagaland,2009,Borstal School,0,0,0,0,0,0,0,0,0,0,0,0,0,0,0
1949,Nagaland,2009,Open Jail,0,0,0,0,0,0,0,0,0,0,0,0,0,0,0
1950,Nagaland,2009,Special Jail,0,0,0,0,0,0,0,0,0,0,0,0,0,0,0
1951,Nagaland,2009,Others,0,0,0,0,0,0,0,0,0,0,0,0,0,0,0
1952,Nagaland,2009,Total,152,2,154,412,15,427,42,0,42,0,0,0,606,17,623
1953,Nagaland,2010,Central Jail,96,0,96,152,0,152,33,0,33,0,0,0,281,0,281
1954,Nagaland,2010,District Jail,41,1,42,81,4,85,0,0,0,0,0,0,122,5,127
1955,Nagaland,2010,Sub_Jail,22,3,25,78,10,88,0,0,0,0,0,0,100,13,113
1956,Nagaland,2010,Women Jail,0,0,0,0,0,0,0,0,0,0,0,0,0,0,0
1957,Nagaland,2010,Borstal School,0,0,0,0,0,0,0,0,0,0,0,0,0,0,0
1958,Nagaland,2010,Open Jail,0,0,0,0,0,0,0,0,0,0,0,0,0,0,0
1959,Nagaland,2010,Special Jail,0,0,0,0,0,0,0,0,0,0,0,0,0,0,0
1960,Nagaland,2010,Others,0,0,0,0,0,0,0,0,0,0,0,0,0,0,0
1961,Nagaland,2010,Total,159,4,163,311,14,325,33,0,33,0,0,0,503,18,521
1962,Nagaland,2011,Central Jail,74,0,74,106,0,106,70,0,70,0,0,0,250,0,250
1963,Nagaland,2011,District Jail,36,1,37,91,2,93,0,0,0,0,0,0,127,3,130
1964,Nagaland,2011,Sub_Jail,13,6,19,94,6,100,2,1,3,0,0,0,109,13,122
1965,Nagaland,2011,Women Jail,0,0,0,0,0,0,0,0,0,0,0,0,0,0,0
1966,Nagaland,2011,Borstal School,0,0,0,0,0,0,0,0,0,0,0,0,0,0,0
1967,Nagaland,2011,Open Jail,0,0,0,0,0,0,0,0,0,0,0,0,0,0,0
1968,Nagaland,2011,Special Jail,0,0,0,0,0,0,0,0,0,0,0,0,0,0,0
1969,Nagaland,2011,Others,0,0,0,0,0,0,0,0,0,0,0,0,0,0,0
1970,Nagaland,2011,Total,123,7,130,291,8,299,72,1,73,0,0,0,486,16,502
1971,Nagaland,2012,Central Jail,67,0,67,69,0,69,16,0,16,1,0,1,153,0,153
1972,Nagaland,2012,District Jail,27,1,28,73,4,77,0,0,0,0,0,0,100,5,105
1973,Nagaland,2012,Sub_Jail,26,4,30,101,6,107,2,1,3,0,0,0,129,11,140
1974,Nagaland,2012,Women Jail,0,0,0,0,0,0,0,0,0,0,0,0,0,0,0
1975,Nagaland,2012,Borstal School,0,0,0,0,0,0,0,0,0,0,0,0,0,0,0
1976,Nagaland,2012,Open Jail,0,0,0,0,0,0,0,0,0,0,0,0,0,0,0
1977,Nagaland,2012,Special Jail,0,0,0,0,0,0,0,0,0,0,0,0,0,0,0
1978,Nagaland,2012,Others,0,0,0,0,0,0,0,0,0,0,0,0,0,0,0
1979,Nagaland,2012,Total,120,5,125,243,10,253,18,1,19,1,0,1,382,16,398
1980,Orissa,2001,Central Jail,0,0,0,0,0,0,0,0,0,0,0,0,0,0,0
1981,Orissa,2001,District Jail,2214,13,2227,3257,76,3333,30,0,30,45,0,45,5546,89,5635
1982,Orissa,2001,Sub_Jail,318,1,319,4027,154,4181,10,0,10,0,0,0,4355,155,4510
1983,Orissa,2001,Women Jail,0,37,37,0,3,3,0,0,0,0,0,0,0,40,40
1984,Orissa,2001,Borstal School,80,0,80,176,0,176,1,0,1,0,0,0,257,0,257
1985,Orissa,2001,Open Jail,0,0,0,0,0,0,0,0,0,0,0,0,0,0,0
1986,Orissa,2001,Special Jail,152,1,153,1059,16,1075,4,0,4,1,0,1,1216,17,1233
1987,Orissa,2001,Others,0,0,0,0,0,0,0,0,0,0,0,0,0,0,0
1988,Orissa,2001,Total,2764,52,2816,8519,249,8768,45,0,45,46,0,46,11374,301,11675
1989,Orissa,2002,Central Jail,0,0,0,0,0,0,0,0,0,0,0,0,0,0,0
1990,Orissa,2002,District Jail,2313,38,2351,3613,105,3718,0,0,0,37,0,37,5963,143,6106
1991,Orissa,2002,Sub_Jail,339,2,341,4457,155,4612,0,0,0,6,0,6,4802,157,4959
1992,Orissa,2002,Women Jail,0,8,8,0,6,6,0,0,0,0,0,0,0,14,14
1993,Orissa,2002,Borstal School,96,0,96,131,0,131,0,0,0,1,0,1,228,0,228
1994,Orissa,2002,Open Jail,0,0,0,0,0,0,0,0,0,0,0,0,0,0,0
1995,Orissa,2002,Special Jail,178,1,179,1123,26,1149,0,0,0,2,0,2,1303,27,1330
1996,Orissa,2002,Others,0,0,0,0,0,0,0,0,0,0,0,0,0,0,0
1997,Orissa,2002,Total,2926,49,2975,9324,292,9616,0,0,0,46,0,46,12296,341,12637
1998,Orissa,2003,Central Jail,0,0,0,0,0,0,0,0,0,0,0,0,0,0,0
1999,Orissa,2003,District Jail,2582,53,2635,3572,101,3673,0,0,0,22,0,22,6176,154,6330
2000,Orissa,2003,Sub_Jail,339,1,340,4654,152,4806,0,0,0,12,0,12,5005,153,5158
2001,Orissa,2003,Women Jail,0,10,10,0,10,10,0,0,0,0,0,0,0,20,20
2002,Orissa,2003,Borstal School,81,0,81,143,0,143,0,0,0,1,0,1,225,0,225
2003,Orissa,2003,Open Jail,0,0,0,0,0,0,0,0,0,0,0,0,0,0,0
2004,Orissa,2003,Special Jail,224,2,226,981,27,1008,0,0,0,0,0,0,1205,29,1234
2005,Orissa,2003,Others,0,0,0,0,0,0,0,0,0,0,0,0,0,0,0
2006,Orissa,2003,Total,3226,66,3292,9350,290,9640,0,0,0,35,0,35,12611,356,12967
2007,Orissa,2004,Central Jail,0,0,0,0,0,0,0,0,0,0,0,0,0,0,0
2008,Orissa,2004,District Jail,2837,49,2886,3526,107,3633,3,0,3,14,1,15,6380,157,6537
2009,Orissa,2004,Sub_Jail,401,5,406,4579,154,4733,3,0,3,9,0,9,4992,159,5151
2010,Orissa,2004,Women Jail,0,9,9,0,5,5,0,0,0,0,0,0,0,14,14
2011,Orissa,2004,Borstal School,72,0,72,163,0,163,1,0,1,1,0,1,237,0,237
2012,Orissa,2004,Open Jail,50,0,50,0,0,0,0,0,0,0,0,0,50,0,50
2013,Orissa,2004,Special Jail,255,2,257,881,29,910,2,0,2,0,0,0,1138,31,1169
2014,Orissa,2004,Others,0,0,0,0,0,0,0,0,0,0,0,0,0,0,0
2015,Orissa,2004,Total,3615,65,3680,9149,295,9444,9,0,9,24,1,25,12797,361,13158
2016,Orissa,2005,Central Jail,0,0,0,0,0,0,0,0,0,0,0,0,0,0,0
2017,Orissa,2005,District Jail,3169,62,3231,3477,124,3601,15,0,15,17,0,17,6678,186,6864
2018,Orissa,2005,Sub_Jail,483,6,489,4791,189,4980,0,0,0,8,0,8,5282,195,5477
2019,Orissa,2005,Women Jail,0,16,16,0,12,12,0,0,0,0,0,0,0,28,28
2020,Orissa,2005,Borstal School,109,0,109,198,0,198,0,0,0,0,0,0,307,0,307
2021,Orissa,2005,Open Jail,39,0,39,0,0,0,0,0,0,0,0,0,39,0,39
2022,Orissa,2005,Special Jail,308,4,312,912,17,929,0,0,0,2,0,2,1222,21,1243
2023,Orissa,2005,Others,0,0,0,0,0,0,0,0,0,0,0,0,0,0,0
2024,Orissa,2005,Total,4108,88,4196,9378,342,9720,15,0,15,27,0,27,13528,430,13958
2025,Orissa,2006,Central Jail,0,0,0,0,0,0,0,0,0,0,0,0,0,0,0
2026,Orissa,2006,District Jail,3234,68,3302,3741,124,3865,0,0,0,22,1,23,6997,193,7190
2027,Orissa,2006,Sub_Jail,578,7,585,5009,224,5233,0,0,0,9,0,9,5596,231,5827
2028,Orissa,2006,Women Jail,0,12,12,0,9,9,0,0,0,0,0,0,0,21,21
2029,Orissa,2006,Borstal School,0,0,0,0,0,0,0,0,0,0,0,0,0,0,0
2030,Orissa,2006,Open Jail,68,0,68,0,0,0,0,0,0,0,0,0,68,0,68
2031,Orissa,2006,Special Jail,301,4,305,947,29,976,0,0,0,0,0,0,1248,33,1281
2032,Orissa,2006,Others,93,0,93,164,0,164,0,0,0,0,0,0,257,0,257
2033,Orissa,2006,Total,4274,91,4365,9861,386,10247,0,0,0,31,1,32,14166,478,14644
2034,Orissa,2007,Central Jail,0,0,0,0,0,0,0,0,0,0,0,0,0,0,0
2035,Orissa,2007,District Jail,3248,75,3323,4011,195,4206,3,0,3,0,0,0,7262,270,7532
2036,Orissa,2007,Sub_Jail,517,9,526,5320,279,5599,0,0,0,0,0,0,5837,288,6125
2037,Orissa,2007,Women Jail,0,14,14,0,14,14,0,0,0,0,0,0,0,28,28
2038,Orissa,2007,Borstal School,0,0,0,0,0,0,0,0,0,0,0,0,0,0,0
2039,Orissa,2007,Open Jail,59,0,59,0,0,0,0,0,0,0,0,0,59,0,59
2040,Orissa,2007,Special Jail,324,5,329,982,29,1011,0,0,0,0,0,0,1306,34,1340
2041,Orissa,2007,Others,94,0,94,190,0,190,0,0,0,0,0,0,284,0,284
2042,Orissa,2007,Total,4242,103,4345,10503,517,11020,3,0,3,0,0,0,14748,620,15368
2043,Orissa,2008,Central Jail,0,0,0,0,0,0,0,0,0,0,0,0,0,0,0
2044,Orissa,2008,District Jail,3105,87,3192,3575,111,3686,12,0,12,0,0,0,6692,198,6890
2045,Orissa,2008,Sub_Jail,558,16,574,4994,231,5225,0,0,0,0,0,0,5552,247,5799
2046,Orissa,2008,Women Jail,0,12,12,0,16,16,0,0,0,0,0,0,0,28,28
2047,Orissa,2008,Borstal School,0,0,0,0,0,0,0,0,0,0,0,0,0,0,0
2048,Orissa,2008,Open Jail,102,0,102,0,0,0,0,0,0,0,0,0,102,0,102
2049,Orissa,2008,Special Jail,322,7,329,872,34,906,0,0,0,0,0,0,1194,41,1235
2050,Orissa,2008,Others,91,0,91,219,9,228,0,0,0,0,0,0,310,9,319
2051,Orissa,2008,Total,4178,122,4300,9660,401,10061,12,0,12,0,0,0,13850,523,14373
2052,Orissa,2009,Central Jail,963,33,996,1414,55,1469,0,0,0,0,0,0,2377,88,2465
2053,Orissa,2009,District Jail,1742,43,1785,1722,73,1795,0,0,0,0,0,0,3464,116,3580
2054,Orissa,2009,Sub_Jail,760,16,776,4911,207,5118,0,0,0,0,0,0,5671,223,5894
2055,Orissa,2009,Women Jail,0,10,10,0,9,9,0,0,0,0,0,0,0,19,19
2056,Orissa,2009,Borstal School,0,0,0,0,0,0,0,0,0,0,0,0,0,0,0
2057,Orissa,2009,Open Jail,98,0,98,0,0,0,0,0,0,0,0,0,98,0,98
2058,Orissa,2009,Special Jail,256,6,262,857,40,897,0,0,0,0,0,0,1113,46,1159
2059,Orissa,2009,Others,96,0,96,216,7,223,0,0,0,0,0,0,312,7,319
2060,Orissa,2009,Total,3915,108,4023,9120,391,9511,0,0,0,0,0,0,13035,499,13534
2061,Orissa,2010,Central Jail,847,37,884,1268,23,1291,0,0,0,0,0,0,2115,60,2175
2062,Orissa,2010,District Jail,1538,39,1577,1970,87,2057,0,0,0,0,0,0,3508,126,3634
2063,Orissa,2010,Sub_Jail,1101,21,1122,4130,223,4353,0,0,0,0,0,0,5231,244,5475
2064,Orissa,2010,Women Jail,0,12,12,0,9,9,0,0,0,0,0,0,0,21,21
2065,Orissa,2010,Borstal School,0,0,0,0,0,0,0,0,0,0,0,0,0,0,0
2066,Orissa,2010,Open Jail,112,0,112,0,0,0,0,0,0,0,0,0,112,0,112
2067,Orissa,2010,Special Jail,239,5,244,734,34,768,0,0,0,0,0,0,973,39,1012
2068,Orissa,2010,Others,0,0,0,0,0,0,0,0,0,0,0,0,0,0,0
2069,Orissa,2010,Total,3837,114,3951,8102,376,8478,0,0,0,0,0,0,11939,490,12429
2070,Orissa,2011,Central Jail,837,41,878,1326,35,1361,0,0,0,0,0,0,2163,76,2239
2071,Orissa,2011,District Jail,1437,37,1474,1800,67,1867,0,0,0,0,0,0,3237,104,3341
2072,Orissa,2011,Sub_Jail,1023,18,1041,4861,185,5046,0,0,0,0,0,0,5884,203,6087
2073,Orissa,2011,Women Jail,0,12,12,0,10,10,0,0,0,0,0,0,0,22,22
2074,Orissa,2011,Borstal School,0,0,0,0,0,0,0,0,0,0,0,0,0,0,0
2075,Orissa,2011,Open Jail,65,0,65,0,0,0,0,0,0,0,0,0,65,0,65
2076,Orissa,2011,Special Jail,227,4,231,734,34,768,0,0,0,0,0,0,961,38,999
2077,Orissa,2011,Others,0,0,0,0,0,0,0,0,0,0,0,0,0,0,0
2078,Orissa,2011,Total,3589,112,3701,8721,331,9052,0,0,0,0,0,0,12310,443,12753
2079,Orissa,2012,Central Jail,1049,37,1086,1637,55,1692,0,0,0,0,0,0,2686,92,2778
2080,Orissa,2012,District Jail,1079,27,1106,1724,57,1781,0,0,0,0,0,0,2803,84,2887
2081,Orissa,2012,Sub_Jail,1064,25,1089,4718,219,4937,0,0,0,0,0,0,5782,244,6026
2082,Orissa,2012,Women Jail,0,8,8,0,11,11,0,0,0,0,0,0,0,19,19
2083,Orissa,2012,Borstal School,0,0,0,0,0,0,0,0,0,0,0,0,0,0,0
2084,Orissa,2012,Open Jail,100,0,100,0,0,0,0,0,0,0,0,0,100,0,100
2085,Orissa,2012,Special Jail,233,8,241,787,29,816,0,0,0,0,0,0,1020,37,1057
2086,Orissa,2012,Others,0,0,0,0,0,0,0,0,0,0,0,0,0,0,0
2087,Orissa,2012,Total,3525,105,3630,8866,371,9237,0,0,0,0,0,0,12391,476,12867
2088,Punjab,2001,Central Jail,2954,63,3017,5786,269,6055,12,0,12,133,2,135,8885,334,9219
2089,Punjab,2001,District Jail,375,4,379,931,80,1011,0,0,0,1,0,1,1307,84,1391
2090,Punjab,2001,Sub_Jail,52,0,52,755,0,755,0,0,0,1,0,1,808,0,808
2091,Punjab,2001,Women Jail,0,103,103,0,104,104,0,0,0,0,3,3,0,210,210
2092,Punjab,2001,Borstal School,94,0,94,233,0,233,0,0,0,0,0,0,327,0,327
2093,Punjab,2001,Open Jail,22,0,22,0,0,0,0,0,0,0,0,0,22,0,22
2094,Punjab,2001,Special Jail,27,0,27,50,0,50,0,0,0,0,0,0,77,0,77
2095,Punjab,2001,Others,0,0,0,0,0,0,0,0,0,0,0,0,0,0,0
2096,Punjab,2001,Total,3524,170,3694,7755,453,8208,12,0,12,135,5,140,11426,628,12054
2097,Punjab,2002,Central Jail,3018,82,3100,5391,273,5664,0,0,0,0,0,0,8409,355,8764
2098,Punjab,2002,District Jail,519,26,545,1184,100,1284,12,0,12,0,0,0,1715,126,1841
2099,Punjab,2002,Sub_Jail,74,0,74,828,0,828,0,0,0,0,0,0,902,0,902
2100,Punjab,2002,Women Jail,0,151,151,0,98,98,0,0,0,0,0,0,0,249,249
2101,Punjab,2002,Borstal School,89,0,89,239,0,239,0,0,0,0,0,0,328,0,328
2102,Punjab,2002,Open Jail,25,0,25,0,0,0,0,0,0,0,0,0,25,0,25
2103,Punjab,2002,Special Jail,0,0,0,0,0,0,0,0,0,0,0,0,0,0,0
2104,Punjab,2002,Others,0,0,0,0,0,0,0,0,0,0,0,0,0,0,0
2105,Punjab,2002,Total,3725,259,3984,7642,471,8113,12,0,12,0,0,0,11379,730,12109
2106,Punjab,2003,Central Jail,3232,72,3304,6223,333,6556,2,0,2,31,0,31,9488,405,9893
2107,Punjab,2003,District Jail,708,27,735,1227,104,1331,0,0,0,0,0,0,1935,131,2066
2108,Punjab,2003,Sub_Jail,55,0,55,560,0,560,0,0,0,0,0,0,615,0,615
2109,Punjab,2003,Women Jail,0,165,165,0,101,101,0,0,0,0,0,0,0,266,266
2110,Punjab,2003,Borstal School,125,0,125,234,0,234,0,0,0,0,0,0,359,0,359
2111,Punjab,2003,Open Jail,33,0,33,0,0,0,0,0,0,0,0,0,33,0,33
2112,Punjab,2003,Special Jail,0,0,0,0,0,0,0,0,0,0,0,0,0,0,0
2113,Punjab,2003,Others,0,0,0,0,0,0,0,0,0,0,0,0,0,0,0
2114,Punjab,2003,Total,4153,264,4417,8244,538,8782,2,0,2,31,0,31,12430,802,13232
2115,Punjab,2004,Central Jail,3786,65,3851,6928,291,7219,4,0,4,15,0,15,10733,356,11089
2116,Punjab,2004,District Jail,737,31,768,1421,106,1527,19,0,19,0,0,0,2177,137,2314
2117,Punjab,2004,Sub_Jail,91,0,91,842,0,842,0,0,0,0,0,0,933,0,933
2118,Punjab,2004,Women Jail,0,178,178,0,104,104,0,0,0,0,0,0,0,282,282
2119,Punjab,2004,Borstal School,110,0,110,309,0,309,0,0,0,0,0,0,419,0,419
2120,Punjab,2004,Open Jail,27,0,27,0,0,0,0,0,0,0,0,0,27,0,27
2121,Punjab,2004,Special Jail,0,0,0,0,0,0,0,0,0,0,0,0,0,0,0
2122,Punjab,2004,Others,0,0,0,0,0,0,0,0,0,0,0,0,0,0,0
2123,Punjab,2004,Total,4751,274,5025,9500,501,10001,23,0,23,15,0,15,14289,775,15064
2124,Punjab,2005,Central Jail,3855,105,3960,6544,319,6863,3,0,3,9,0,9,10411,424,10835
2125,Punjab,2005,District Jail,673,36,709,1316,92,1408,20,0,20,2,0,2,2011,128,2139
2126,Punjab,2005,Sub_Jail,188,0,188,961,0,961,0,0,0,0,0,0,1149,0,1149
2127,Punjab,2005,Women Jail,0,96,96,0,132,132,0,0,0,0,0,0,0,228,228
2128,Punjab,2005,Borstal School,77,0,77,208,0,208,0,0,0,0,0,0,285,0,285
2129,Punjab,2005,Open Jail,42,0,42,0,0,0,0,0,0,0,0,0,42,0,42
2130,Punjab,2005,Special Jail,0,0,0,0,0,0,0,0,0,0,0,0,0,0,0
2131,Punjab,2005,Others,0,0,0,0,0,0,0,0,0,0,0,0,0,0,0
2132,Punjab,2005,Total,4835,237,5072,9029,543,9572,23,0,23,11,0,11,13898,780,14678
2133,Punjab,2006,Central Jail,3841,120,3961,6593,342,6935,2,0,2,4,0,4,10440,462,10902
2134,Punjab,2006,District Jail,910,39,949,1392,69,1461,18,0,18,0,0,0,2320,108,2428
2135,Punjab,2006,Sub_Jail,241,0,241,1059,0,1059,0,0,0,0,0,0,1300,0,1300
2136,Punjab,2006,Women Jail,0,98,98,0,108,108,0,0,0,0,0,0,0,206,206
2137,Punjab,2006,Borstal School,62,0,62,188,0,188,0,0,0,0,0,0,250,0,250
2138,Punjab,2006,Open Jail,29,0,29,0,0,0,0,0,0,0,0,0,29,0,29
2139,Punjab,2006,Special Jail,0,0,0,0,0,0,0,0,0,0,0,0,0,0,0
2140,Punjab,2006,Others,0,0,0,0,0,0,0,0,0,0,0,0,0,0,0
2141,Punjab,2006,Total,5083,257,5340,9232,519,9751,20,0,20,4,0,4,14339,776,15115
2142,Punjab,2007,Central Jail,3434,114,3548,7293,398,7691,0,0,0,13,0,13,10740,512,11252
2143,Punjab,2007,District Jail,924,31,955,1654,78,1732,16,0,16,0,0,0,2594,109,2703
2144,Punjab,2007,Sub_Jail,247,0,247,1183,0,1183,0,0,0,3,0,3,1433,0,1433
2145,Punjab,2007,Women Jail,0,69,69,0,145,145,0,0,0,0,0,0,0,214,214
2146,Punjab,2007,Borstal School,85,0,85,230,0,230,0,0,0,0,0,0,315,0,315
2147,Punjab,2007,Open Jail,55,0,55,0,0,0,0,0,0,0,0,0,55,0,55
2148,Punjab,2007,Special Jail,0,0,0,0,0,0,0,0,0,0,0,0,0,0,0
2149,Punjab,2007,Others,0,0,0,0,0,0,0,0,0,0,0,0,0,0,0
2150,Punjab,2007,Total,4745,214,4959,10360,621,10981,16,0,16,16,0,16,15137,835,15972
2151,Punjab,2008,Central Jail,3872,152,4024,6908,316,7224,1,0,1,1,0,1,10782,468,11250
2152,Punjab,2008,District Jail,937,30,967,1671,120,1791,12,0,12,0,0,0,2620,150,2770
2153,Punjab,2008,Sub_Jail,241,0,241,1145,0,1145,0,0,0,1,0,1,1387,0,1387
2154,Punjab,2008,Women Jail,0,82,82,0,122,122,0,0,0,0,0,0,0,204,204
2155,Punjab,2008,Borstal School,98,0,98,347,0,347,0,0,0,0,0,0,445,0,445
2156,Punjab,2008,Open Jail,59,0,59,0,0,0,0,0,0,0,0,0,59,0,59
2157,Punjab,2008,Special Jail,0,0,0,0,0,0,0,0,0,0,0,0,0,0,0
2158,Punjab,2008,Others,0,0,0,0,0,0,0,0,0,0,0,0,0,0,0
2159,Punjab,2008,Total,5207,264,5471,10071,558,10629,13,0,13,2,0,2,15293,822,16115
2160,Punjab,2009,Central Jail,4514,216,4730,7585,345,7930,0,0,0,7,0,7,12106,561,12667
2161,Punjab,2009,District Jail,1235,51,1286,1809,141,1950,11,0,11,5,0,5,3060,192,3252
2162,Punjab,2009,Sub_Jail,160,0,160,993,0,993,2,0,2,0,0,0,1155,0,1155
2163,Punjab,2009,Women Jail,0,85,85,0,143,143,0,0,0,0,0,0,0,228,228
2164,Punjab,2009,Borstal School,115,0,115,375,0,375,0,0,0,0,0,0,490,0,490
2165,Punjab,2009,Open Jail,62,0,62,0,0,0,0,0,0,0,0,0,62,0,62
2166,Punjab,2009,Special Jail,0,0,0,0,0,0,0,0,0,0,0,0,0,0,0
2167,Punjab,2009,Others,0,0,0,0,0,0,0,0,0,0,0,0,0,0,0
2168,Punjab,2009,Total,6086,352,6438,10762,629,11391,13,0,13,12,0,12,16873,981,17854
2169,Punjab,2010,Central Jail,4795,215,5010,7170,448,7618,0,0,0,0,0,0,11965,663,12628
2170,Punjab,2010,District Jail,1149,54,1203,1902,108,2010,0,0,0,0,0,0,3051,162,3213
2171,Punjab,2010,Sub_Jail,199,0,199,957,0,957,0,0,0,0,0,0,1156,0,1156
2172,Punjab,2010,Women Jail,0,87,87,0,106,106,0,0,0,0,0,0,0,193,193
2173,Punjab,2010,Borstal School,92,0,92,304,0,304,0,0,0,0,0,0,396,0,396
2174,Punjab,2010,Open Jail,58,0,58,0,0,0,0,0,0,0,0,0,58,0,58
2175,Punjab,2010,Special Jail,0,0,0,0,0,0,0,0,0,0,0,0,0,0,0
2176,Punjab,2010,Others,0,0,0,0,0,0,0,0,0,0,0,0,0,0,0
2177,Punjab,2010,Total,6293,356,6649,10333,662,10995,0,0,0,0,0,0,16626,1018,17644
2178,Punjab,2011,Central Jail,5118,247,5365,6770,369,7139,0,0,0,0,0,0,11888,616,12504
2179,Punjab,2011,District Jail,1488,78,1566,1803,101,1904,0,0,0,0,0,0,3291,179,3470
2180,Punjab,2011,Sub_Jail,303,0,303,806,0,806,0,0,0,0,0,0,1109,0,1109
2181,Punjab,2011,Women Jail,0,129,129,0,113,113,0,0,0,0,0,0,0,242,242
2182,Punjab,2011,Borstal School,123,0,123,333,0,333,0,0,0,0,0,0,456,0,456
2183,Punjab,2011,Open Jail,40,0,40,0,0,0,0,0,0,0,0,0,40,0,40
2184,Punjab,2011,Special Jail,0,0,0,0,0,0,0,0,0,0,0,0,0,0,0
2185,Punjab,2011,Others,0,0,0,0,0,0,0,0,0,0,0,0,0,0,0
2186,Punjab,2011,Total,7072,454,7526,9712,583,10295,0,0,0,0,0,0,16784,1037,17821
2187,Punjab,2012,Central Jail,5491,217,5708,10712,544,11256,4,1,5,2,0,2,16209,762,16971
2188,Punjab,2012,District Jail,1521,109,1630,2325,182,2507,3,0,3,0,0,0,3849,291,4140
2189,Punjab,2012,Sub_Jail,257,0,257,1169,0,1169,0,0,0,3,0,3,1429,0,1429
2190,Punjab,2012,Women Jail,0,81,81,0,139,139,0,0,0,0,2,2,0,222,222
2191,Punjab,2012,Borstal School,93,0,93,302,0,302,0,0,0,0,0,0,395,0,395
2192,Punjab,2012,Open Jail,62,0,62,0,0,0,0,0,0,0,0,0,62,0,62
2193,Punjab,2012,Special Jail,0,0,0,0,0,0,0,0,0,0,0,0,0,0,0
2194,Punjab,2012,Others,0,0,0,0,0,0,0,0,0,0,0,0,0,0,0
2195,Punjab,2012,Total,7424,407,7831,14508,865,15373,7,1,8,5,2,7,21944,1275,23219
2196,Rajasthan,2001,Central Jail,3328,0,3328,2813,92,2905,45,0,45,16,0,16,6202,92,6294
2197,Rajasthan,2001,District Jail,411,0,411,3508,107,3615,2,0,2,10,0,10,3931,107,4038
2198,Rajasthan,2001,Sub_Jail,11,0,11,2148,27,2175,0,0,0,2,0,2,2161,27,2188
2199,Rajasthan,2001,Women Jail,0,96,96,0,42,42,0,0,0,0,0,0,0,138,138
2200,Rajasthan,2001,Borstal School,33,0,33,0,0,0,0,0,0,0,0,0,33,0,33
2201,Rajasthan,2001,Open Jail,297,7,304,0,0,0,0,0,0,0,0,0,297,7,304
2202,Rajasthan,2001,Special Jail,0,0,0,0,0,0,0,0,0,0,0,0,0,0,0
2203,Rajasthan,2001,Others,0,0,0,0,0,0,0,0,0,0,0,0,0,0,0
2204,Rajasthan,2001,Total,4080,103,4183,8469,268,8737,47,0,47,28,0,28,12624,371,12995
2205,Rajasthan,2002,Central Jail,3658,0,3658,2321,56,2377,37,0,37,31,0,31,6047,56,6103
2206,Rajasthan,2002,District Jail,738,9,747,2847,101,2948,1,0,1,17,0,17,3603,110,3713
2207,Rajasthan,2002,Sub_Jail,16,1,17,1947,19,1966,0,0,0,2,0,2,1965,20,1985
2208,Rajasthan,2002,Women Jail,0,165,165,0,31,31,0,0,0,0,0,0,0,196,196
2209,Rajasthan,2002,Borstal School,46,0,46,0,0,0,0,0,0,0,0,0,46,0,46
2210,Rajasthan,2002,Open Jail,332,11,343,0,0,0,0,0,0,0,0,0,332,11,343
2211,Rajasthan,2002,Special Jail,0,0,0,0,0,0,0,0,0,0,0,0,0,0,0
2212,Rajasthan,2002,Others,0,0,0,0,0,0,0,0,0,0,0,0,0,0,0
2213,Rajasthan,2002,Total,4790,186,4976,7115,207,7322,38,0,38,50,0,50,11993,393,12386
2214,Rajasthan,2003,Central Jail,4954,0,4954,2333,86,2419,31,0,31,15,0,15,7333,86,7419
2215,Rajasthan,2003,District Jail,558,1,559,2181,78,2259,1,0,1,8,0,8,2748,79,2827
2216,Rajasthan,2003,Sub_Jail,19,0,19,1852,21,1873,0,0,0,3,0,3,1874,21,1895
2217,Rajasthan,2003,Women Jail,0,180,180,0,33,33,0,0,0,0,0,0,0,213,213
2218,Rajasthan,2003,Borstal School,39,0,39,0,0,0,0,0,0,0,0,0,39,0,39
2219,Rajasthan,2003,Open Jail,291,11,302,0,0,0,0,0,0,0,0,0,291,11,302
2220,Rajasthan,2003,Special Jail,0,0,0,0,0,0,0,0,0,0,0,0,0,0,0
2221,Rajasthan,2003,Others,0,0,0,0,0,0,0,0,0,0,0,0,0,0,0
2222,Rajasthan,2003,Total,5861,192,6053,6366,218,6584,32,0,32,26,0,26,12285,410,12695
2223,Rajasthan,2004,Central Jail,4724,0,4724,2676,93,2769,29,0,29,10,0,10,7439,93,7532
2224,Rajasthan,2004,District Jail,512,0,512,2357,93,2450,0,0,0,10,0,10,2879,93,2972
2225,Rajasthan,2004,Sub_Jail,12,0,12,1995,18,2013,0,0,0,1,0,1,2008,18,2026
2226,Rajasthan,2004,Women Jail,0,164,164,0,51,51,0,0,0,0,0,0,0,215,215
2227,Rajasthan,2004,Borstal School,20,0,20,0,0,0,0,0,0,0,0,0,20,0,20
2228,Rajasthan,2004,Open Jail,391,15,406,0,0,0,0,0,0,0,0,0,391,15,406
2229,Rajasthan,2004,Special Jail,0,0,0,0,0,0,0,0,0,0,0,0,0,0,0
2230,Rajasthan,2004,Others,0,0,0,0,0,0,0,0,0,0,0,0,0,0,0
2231,Rajasthan,2004,Total,5659,179,5838,7028,255,7283,29,0,29,21,0,21,12737,434,13171
2232,Rajasthan,2005,Central Jail,4153,0,4153,2730,119,2849,32,0,32,16,0,16,6931,119,7050
2233,Rajasthan,2005,District Jail,799,0,799,2497,81,2578,0,0,0,9,0,9,3305,81,3386
2234,Rajasthan,2005,Sub_Jail,11,0,11,1889,9,1898,0,0,0,1,0,1,1901,9,1910
2235,Rajasthan,2005,Women Jail,0,167,167,0,38,38,0,0,0,0,0,0,0,205,205
2236,Rajasthan,2005,Borstal School,32,0,32,0,0,0,0,0,0,0,0,0,32,0,32
2237,Rajasthan,2005,Open Jail,396,14,410,0,0,0,0,0,0,0,0,0,396,14,410
2238,Rajasthan,2005,Special Jail,0,0,0,0,0,0,0,0,0,0,0,0,0,0,0
2239,Rajasthan,2005,Others,0,0,0,0,0,0,0,0,0,0,0,0,0,0,0
2240,Rajasthan,2005,Total,5391,181,5572,7116,247,7363,32,0,32,26,0,26,12565,428,12993
2241,Rajasthan,2006,Central Jail,4497,1,4498,3000,96,3096,35,0,35,24,0,24,7556,97,7653
2242,Rajasthan,2006,District Jail,477,4,481,2859,130,2989,0,0,0,32,0,32,3368,134,3502
2243,Rajasthan,2006,Sub_Jail,20,0,20,2145,10,2155,0,0,0,11,0,11,2176,10,2186
2244,Rajasthan,2006,Women Jail,0,167,167,0,48,48,0,0,0,0,0,0,0,215,215
2245,Rajasthan,2006,Borstal School,16,0,16,0,0,0,0,0,0,0,0,0,16,0,16
2246,Rajasthan,2006,Open Jail,396,15,411,0,0,0,0,0,0,0,0,0,396,15,411
2247,Rajasthan,2006,Special Jail,0,0,0,0,0,0,0,0,0,0,0,0,0,0,0
2248,Rajasthan,2006,Others,0,0,0,0,0,0,0,0,0,0,0,0,0,0,0
2249,Rajasthan,2006,Total,5406,187,5593,8004,284,8288,35,0,35,67,0,67,13512,471,13983
2250,Rajasthan,2007,Central Jail,4685,7,4692,3170,113,3283,20,0,20,26,0,26,7901,120,8021
2251,Rajasthan,2007,District Jail,550,0,550,3014,131,3145,4,0,4,0,0,0,3568,131,3699
2252,Rajasthan,2007,Sub_Jail,14,0,14,2239,26,2265,2,0,2,0,0,0,2255,26,2281
2253,Rajasthan,2007,Women Jail,0,170,170,0,72,72,0,0,0,0,0,0,0,242,242
2254,Rajasthan,2007,Borstal School,13,0,13,0,0,0,0,0,0,0,0,0,13,0,13
2255,Rajasthan,2007,Open Jail,416,15,431,0,0,0,0,0,0,0,0,0,416,15,431
2256,Rajasthan,2007,Special Jail,0,0,0,0,0,0,0,0,0,0,0,0,0,0,0
2257,Rajasthan,2007,Others,0,0,0,0,0,0,0,0,0,0,0,0,0,0,0
2258,Rajasthan,2007,Total,5678,192,5870,8423,342,8765,26,0,26,26,0,26,14153,534,14687
2259,Rajasthan,2008,Central Jail,4660,0,4660,3281,92,3373,48,0,48,57,0,57,8046,92,8138
2260,Rajasthan,2008,District Jail,887,0,887,3194,152,3346,4,0,4,8,0,8,4093,152,4245
2261,Rajasthan,2008,Sub_Jail,19,1,20,2315,25,2340,3,0,3,0,0,0,2337,26,2363
2262,Rajasthan,2008,Women Jail,0,198,198,0,61,61,0,0,0,0,0,0,0,259,259
2263,Rajasthan,2008,Borstal School,13,0,13,0,0,0,0,0,0,0,0,0,13,0,13
2264,Rajasthan,2008,Open Jail,484,18,502,0,0,0,0,0,0,0,0,0,484,18,502
2265,Rajasthan,2008,Special Jail,0,0,0,0,0,0,0,0,0,0,0,0,0,0,0
2266,Rajasthan,2008,Others,0,0,0,0,0,0,0,0,0,0,0,0,0,0,0
2267,Rajasthan,2008,Total,6063,217,6280,8790,330,9120,55,0,55,65,0,65,14973,547,15520
2268,Rajasthan,2009,Central Jail,4958,8,4966,4069,140,4209,26,0,26,28,0,28,9081,148,9229
2269,Rajasthan,2009,District Jail,835,0,835,4166,153,4319,0,0,0,10,0,10,5011,153,5164
2270,Rajasthan,2009,Sub_Jail,10,0,10,2667,28,2695,1,0,1,2,0,2,2680,28,2708
2271,Rajasthan,2009,Women Jail,0,222,222,0,90,90,0,0,0,0,0,0,0,312,312
2272,Rajasthan,2009,Borstal School,13,0,13,0,0,0,0,0,0,0,0,0,13,0,13
2273,Rajasthan,2009,Open Jail,491,15,506,0,0,0,0,0,0,0,0,0,491,15,506
2274,Rajasthan,2009,Special Jail,0,0,0,0,0,0,0,0,0,0,0,0,0,0,0
2275,Rajasthan,2009,Others,0,0,0,0,0,0,0,0,0,0,0,0,0,0,0
2276,Rajasthan,2009,Total,6307,245,6552,10902,411,11313,27,0,27,40,0,40,17276,656,17932
2277,Rajasthan,2010,Central Jail,4745,0,4745,3874,120,3994,24,0,24,4,0,4,8647,120,8767
2278,Rajasthan,2010,District Jail,753,3,756,3995,160,4155,6,0,6,0,0,0,4754,163,4917
2279,Rajasthan,2010,Sub_Jail,12,0,12,2674,22,2696,0,0,0,0,0,0,2686,22,2708
2280,Rajasthan,2010,Women Jail,0,204,204,0,83,83,0,0,0,0,0,0,0,287,287
2281,Rajasthan,2010,Borstal School,10,0,10,0,0,0,0,0,0,0,0,0,10,0,10
2282,Rajasthan,2010,Open Jail,490,15,505,0,0,0,0,0,0,0,0,0,490,15,505
2283,Rajasthan,2010,Special Jail,0,0,0,0,0,0,0,0,0,0,0,0,0,0,0
2284,Rajasthan,2010,Others,0,0,0,0,0,0,0,0,0,0,0,0,0,0,0
2285,Rajasthan,2010,Total,6010,222,6232,10543,385,10928,30,0,30,4,0,4,16587,607,17194
2286,Rajasthan,2011,Central Jail,4599,6,4605,4407,141,4548,19,0,19,3,0,3,9028,147,9175
2287,Rajasthan,2011,District Jail,765,0,765,4287,157,4444,18,0,18,3,0,3,5073,157,5230
2288,Rajasthan,2011,Sub_Jail,12,0,12,2786,10,2796,3,0,3,0,0,0,2801,10,2811
2289,Rajasthan,2011,Women Jail,0,211,211,0,111,111,0,0,0,0,0,0,0,322,322
2290,Rajasthan,2011,Borstal School,9,0,9,0,0,0,0,0,0,0,0,0,9,0,9
2291,Rajasthan,2011,Open Jail,543,14,557,0,0,0,0,0,0,0,0,0,543,14,557
2292,Rajasthan,2011,Special Jail,0,0,0,0,0,0,0,0,0,0,0,0,0,0,0
2293,Rajasthan,2011,Others,0,0,0,0,0,0,0,0,0,0,0,0,0,0,0
2294,Rajasthan,2011,Total,5928,231,6159,11480,419,11899,40,0,40,6,0,6,17454,650,18104
2295,Rajasthan,2012,Central Jail,4480,0,4480,4933,130,5063,1,0,1,86,0,86,9500,130,9630
2296,Rajasthan,2012,District Jail,778,0,778,4903,189,5092,0,0,0,7,0,7,5688,189,5877
2297,Rajasthan,2012,Sub_Jail,2,0,2,2879,6,2885,0,0,0,4,0,4,2885,6,2891
2298,Rajasthan,2012,Women Jail,0,228,228,0,130,130,0,0,0,0,0,0,0,358,358
2299,Rajasthan,2012,Borstal School,18,0,18,0,0,0,0,0,0,0,0,0,18,0,18
2300,Rajasthan,2012,Open Jail,565,12,577,0,0,0,0,0,0,0,0,0,565,12,577
2301,Rajasthan,2012,Special Jail,0,0,0,0,0,0,0,0,0,0,0,0,0,0,0
2302,Rajasthan,2012,Others,0,0,0,0,0,0,0,0,0,0,0,0,0,0,0
2303,Rajasthan,2012,Total,5843,240,6083,12715,455,13170,1,0,1,97,0,97,18656,695,19351
2304,Sikkim,2001,Central Jail,77,0,77,109,0,109,0,0,0,0,0,0,186,0,186
2305,Sikkim,2001,District Jail,0,0,0,0,0,0,0,0,0,0,0,0,0,0,0
2306,Sikkim,2001,Sub_Jail,0,0,0,0,0,0,0,0,0,0,0,0,0,0,0
2307,Sikkim,2001,Women Jail,0,0,0,0,0,0,0,0,0,0,0,0,0,0,0
2308,Sikkim,2001,Borstal School,0,0,0,0,0,0,0,0,0,0,0,0,0,0,0
2309,Sikkim,2001,Open Jail,0,0,0,0,0,0,0,0,0,0,0,0,0,0,0
2310,Sikkim,2001,Special Jail,0,0,0,0,0,0,0,0,0,0,0,0,0,0,0
2311,Sikkim,2001,Others,0,0,0,0,0,0,0,0,0,0,0,0,0,0,0
2312,Sikkim,2001,Total,77,0,77,109,0,109,0,0,0,0,0,0,186,0,186
2313,Sikkim,2002,Central Jail,81,0,81,89,2,91,0,0,0,0,0,0,170,2,172
2314,Sikkim,2002,District Jail,0,0,0,0,0,0,0,0,0,0,0,0,0,0,0
2315,Sikkim,2002,Sub_Jail,0,0,0,0,0,0,0,0,0,0,0,0,0,0,0
2316,Sikkim,2002,Women Jail,0,0,0,0,0,0,0,0,0,0,0,0,0,0,0
2317,Sikkim,2002,Borstal School,0,0,0,0,0,0,0,0,0,0,0,0,0,0,0
2318,Sikkim,2002,Open Jail,0,0,0,0,0,0,0,0,0,0,0,0,0,0,0
2319,Sikkim,2002,Special Jail,0,0,0,0,0,0,0,0,0,0,0,0,0,0,0
2320,Sikkim,2002,Others,0,0,0,0,0,0,0,0,0,0,0,0,0,0,0
2321,Sikkim,2002,Total,81,0,81,89,2,91,0,0,0,0,0,0,170,2,172
2322,Sikkim,2003,Central Jail,80,2,82,87,2,89,0,0,0,0,0,0,167,4,171
2323,Sikkim,2003,District Jail,0,0,0,0,0,0,0,0,0,0,0,0,0,0,0
2324,Sikkim,2003,Sub_Jail,0,0,0,0,0,0,0,0,0,0,0,0,0,0,0
2325,Sikkim,2003,Women Jail,0,0,0,0,0,0,0,0,0,0,0,0,0,0,0
2326,Sikkim,2003,Borstal School,0,0,0,0,0,0,0,0,0,0,0,0,0,0,0
2327,Sikkim,2003,Open Jail,0,0,0,0,0,0,0,0,0,0,0,0,0,0,0
2328,Sikkim,2003,Special Jail,0,0,0,0,0,0,0,0,0,0,0,0,0,0,0
2329,Sikkim,2003,Others,0,0,0,0,0,0,0,0,0,0,0,0,0,0,0
2330,Sikkim,2003,Total,80,2,82,87,2,89,0,0,0,0,0,0,167,4,171
2331,Sikkim,2004,Central Jail,61,2,63,99,0,99,0,0,0,0,0,0,160,2,162
2332,Sikkim,2004,District Jail,0,0,0,0,0,0,0,0,0,0,0,0,0,0,0
2333,Sikkim,2004,Sub_Jail,0,0,0,0,0,0,0,0,0,0,0,0,0,0,0
2334,Sikkim,2004,Women Jail,0,0,0,0,0,0,0,0,0,0,0,0,0,0,0
2335,Sikkim,2004,Borstal School,0,0,0,0,0,0,0,0,0,0,0,0,0,0,0
2336,Sikkim,2004,Open Jail,0,0,0,0,0,0,0,0,0,0,0,0,0,0,0
2337,Sikkim,2004,Special Jail,0,0,0,0,0,0,0,0,0,0,0,0,0,0,0
2338,Sikkim,2004,Others,0,0,0,0,0,0,0,0,0,0,0,0,0,0,0
2339,Sikkim,2004,Total,61,2,63,99,0,99,0,0,0,0,0,0,160,2,162
2340,Sikkim,2005,Central Jail,71,2,73,117,5,122,0,0,0,0,0,0,188,7,195
2341,Sikkim,2005,District Jail,0,0,0,0,0,0,0,0,0,0,0,0,0,0,0
2342,Sikkim,2005,Sub_Jail,0,0,0,0,0,0,0,0,0,0,0,0,0,0,0
2343,Sikkim,2005,Women Jail,0,0,0,0,0,0,0,0,0,0,0,0,0,0,0
2344,Sikkim,2005,Borstal School,0,0,0,0,0,0,0,0,0,0,0,0,0,0,0
2345,Sikkim,2005,Open Jail,0,0,0,0,0,0,0,0,0,0,0,0,0,0,0
2346,Sikkim,2005,Special Jail,0,0,0,0,0,0,0,0,0,0,0,0,0,0,0
2347,Sikkim,2005,Others,0,0,0,0,0,0,0,0,0,0,0,0,0,0,0
2348,Sikkim,2005,Total,71,2,73,117,5,122,0,0,0,0,0,0,188,7,195
2349,Sikkim,2006,Central Jail,90,1,91,132,2,134,0,0,0,0,0,0,222,3,225
2350,Sikkim,2006,District Jail,0,0,0,0,0,0,0,0,0,0,0,0,0,0,0
2351,Sikkim,2006,Sub_Jail,0,0,0,0,0,0,0,0,0,0,0,0,0,0,0
2352,Sikkim,2006,Women Jail,0,0,0,0,0,0,0,0,0,0,0,0,0,0,0
2353,Sikkim,2006,Borstal School,0,0,0,0,0,0,0,0,0,0,0,0,0,0,0
2354,Sikkim,2006,Open Jail,0,0,0,0,0,0,0,0,0,0,0,0,0,0,0
2355,Sikkim,2006,Special Jail,0,0,0,0,0,0,0,0,0,0,0,0,0,0,0
2356,Sikkim,2006,Others,0,0,0,0,0,0,0,0,0,0,0,0,0,0,0
2357,Sikkim,2006,Total,90,1,91,132,2,134,0,0,0,0,0,0,222,3,225
2358,Sikkim,2007,Central Jail,81,1,82,92,3,95,0,0,0,0,0,0,173,4,177
2359,Sikkim,2007,District Jail,0,0,0,49,0,49,0,0,0,0,0,0,49,0,49
2360,Sikkim,2007,Sub_Jail,0,0,0,0,0,0,0,0,0,0,0,0,0,0,0
2361,Sikkim,2007,Women Jail,0,0,0,0,0,0,0,0,0,0,0,0,0,0,0
2362,Sikkim,2007,Borstal School,0,0,0,0,0,0,0,0,0,0,0,0,0,0,0
2363,Sikkim,2007,Open Jail,0,0,0,0,0,0,0,0,0,0,0,0,0,0,0
2364,Sikkim,2007,Special Jail,0,0,0,0,0,0,0,0,0,0,0,0,0,0,0
2365,Sikkim,2007,Others,0,0,0,0,0,0,0,0,0,0,0,0,0,0,0
2366,Sikkim,2007,Total,81,1,82,141,3,144,0,0,0,0,0,0,222,4,226
2367,Sikkim,2008,Central Jail,67,1,68,105,7,112,0,0,0,0,0,0,172,8,180
2368,Sikkim,2008,District Jail,0,0,0,79,1,80,0,0,0,0,0,0,79,1,80
2369,Sikkim,2008,Sub_Jail,0,0,0,0,0,0,0,0,0,0,0,0,0,0,0
2370,Sikkim,2008,Women Jail,0,0,0,0,0,0,0,0,0,0,0,0,0,0,0
2371,Sikkim,2008,Borstal School,0,0,0,0,0,0,0,0,0,0,0,0,0,0,0
2372,Sikkim,2008,Open Jail,0,0,0,0,0,0,0,0,0,0,0,0,0,0,0
2373,Sikkim,2008,Special Jail,0,0,0,0,0,0,0,0,0,0,0,0,0,0,0
2374,Sikkim,2008,Others,0,0,0,0,0,0,0,0,0,0,0,0,0,0,0
2375,Sikkim,2008,Total,67,1,68,184,8,192,0,0,0,0,0,0,251,9,260
2376,Sikkim,2009,Central Jail,68,1,69,60,5,65,0,0,0,0,0,0,128,6,134
2377,Sikkim,2009,District Jail,0,0,0,58,1,59,0,0,0,0,0,0,58,1,59
2378,Sikkim,2009,Sub_Jail,0,0,0,0,0,0,0,0,0,0,0,0,0,0,0
2379,Sikkim,2009,Women Jail,0,0,0,0,0,0,0,0,0,0,0,0,0,0,0
2380,Sikkim,2009,Borstal School,0,0,0,0,0,0,0,0,0,0,0,0,0,0,0
2381,Sikkim,2009,Open Jail,0,0,0,0,0,0,0,0,0,0,0,0,0,0,0
2382,Sikkim,2009,Special Jail,0,0,0,0,0,0,0,0,0,0,0,0,0,0,0
2383,Sikkim,2009,Others,0,0,0,0,0,0,0,0,0,0,0,0,0,0,0
2384,Sikkim,2009,Total,68,1,69,118,6,124,0,0,0,0,0,0,186,7,193
2385,Sikkim,2010,Central Jail,74,2,76,64,3,67,0,0,0,0,0,0,138,5,143
2386,Sikkim,2010,District Jail,0,0,0,62,2,64,0,0,0,0,0,0,62,2,64
2387,Sikkim,2010,Sub_Jail,0,0,0,0,0,0,0,0,0,0,0,0,0,0,0
2388,Sikkim,2010,Women Jail,0,0,0,0,0,0,0,0,0,0,0,0,0,0,0
2389,Sikkim,2010,Borstal School,0,0,0,0,0,0,0,0,0,0,0,0,0,0,0
2390,Sikkim,2010,Open Jail,0,0,0,0,0,0,0,0,0,0,0,0,0,0,0
2391,Sikkim,2010,Special Jail,0,0,0,0,0,0,0,0,0,0,0,0,0,0,0
2392,Sikkim,2010,Others,0,0,0,0,0,0,0,0,0,0,0,0,0,0,0
2393,Sikkim,2010,Total,74,2,76,126,5,131,0,0,0,0,0,0,200,7,207
2394,Sikkim,2011,Central Jail,69,1,70,60,1,61,0,0,0,0,0,0,129,2,131
2395,Sikkim,2011,District Jail,0,0,0,59,0,59,0,0,0,0,0,0,59,0,59
2396,Sikkim,2011,Sub_Jail,0,0,0,0,0,0,0,0,0,0,0,0,0,0,0
2397,Sikkim,2011,Women Jail,0,0,0,0,0,0,0,0,0,0,0,0,0,0,0
2398,Sikkim,2011,Borstal School,0,0,0,0,0,0,0,0,0,0,0,0,0,0,0
2399,Sikkim,2011,Open Jail,0,0,0,0,0,0,0,0,0,0,0,0,0,0,0
2400,Sikkim,2011,Special Jail,0,0,0,0,0,0,0,0,0,0,0,0,0,0,0
2401,Sikkim,2011,Others,0,0,0,0,0,0,0,0,0,0,0,0,0,0,0
2402,Sikkim,2011,Total,69,1,70,119,1,120,0,0,0,0,0,0,188,2,190
2403,Sikkim,2012,Central Jail,87,1,88,73,1,74,0,0,0,0,0,0,160,2,162
2404,Sikkim,2012,District Jail,0,0,0,70,4,74,0,0,0,0,0,0,70,4,74
2405,Sikkim,2012,Sub_Jail,0,0,0,0,0,0,0,0,0,0,0,0,0,0,0
2406,Sikkim,2012,Women Jail,0,0,0,0,0,0,0,0,0,0,0,0,0,0,0
2407,Sikkim,2012,Borstal School,0,0,0,0,0,0,0,0,0,0,0,0,0,0,0
2408,Sikkim,2012,Open Jail,0,0,0,0,0,0,0,0,0,0,0,0,0,0,0
2409,Sikkim,2012,Special Jail,0,0,0,0,0,0,0,0,0,0,0,0,0,0,0
2410,Sikkim,2012,Others,0,0,0,0,0,0,0,0,0,0,0,0,0,0,0
2411,Sikkim,2012,Total,87,1,88,143,5,148,0,0,0,0,0,0,230,6,236
2412,Tamilnadu,2001,Central Jail,4658,5,4663,1822,14,1836,1014,9,1023,7128,30,7158,14622,58,14680
2413,Tamilnadu,2001,District Jail,0,0,0,0,0,0,0,0,0,0,0,0,0,0,0
2414,Tamilnadu,2001,Sub_Jail,4,0,4,378,95,473,0,0,0,3989,832,4821,4371,927,5298
2415,Tamilnadu,2001,Women Jail,0,154,154,0,25,25,0,210,210,0,436,436,0,825,825
2416,Tamilnadu,2001,Borstal School,25,0,25,0,0,0,0,0,0,0,0,0,25,0,25
2417,Tamilnadu,2001,Open Jail,11,0,11,0,0,0,0,0,0,0,0,0,11,0,11
2418,Tamilnadu,2001,Special Jail,0,0,0,24,7,31,0,0,0,247,143,390,271,150,421
2419,Tamilnadu,2001,Others,0,0,0,0,0,0,0,0,0,0,0,0,0,0,0
2420,Tamilnadu,2001,Total,4698,159,4857,2224,141,2365,1014,219,1233,11364,1441,12805,19300,1960,21260
2421,Tamilnadu,2002,Central Jail,5357,5,5362,2480,2,2482,1716,10,1726,6730,32,6762,16283,49,16332
2422,Tamilnadu,2002,District Jail,0,0,0,0,0,0,0,0,0,0,0,0,0,0,0
2423,Tamilnadu,2002,Sub_Jail,2,0,2,22,3,25,0,0,0,3402,528,3930,3426,531,3957
2424,Tamilnadu,2002,Women Jail,0,174,174,0,49,49,0,174,174,0,683,683,0,1080,1080
2425,Tamilnadu,2002,Borstal School,25,0,25,0,0,0,0,0,0,0,0,0,25,0,25
2426,Tamilnadu,2002,Open Jail,16,0,16,0,0,0,0,0,0,0,0,0,16,0,16
2427,Tamilnadu,2002,Special Jail,2,1,3,6,5,11,0,0,0,348,123,471,356,129,485
2428,Tamilnadu,2002,Others,0,0,0,0,0,0,0,0,0,0,0,0,0,0,0
2429,Tamilnadu,2002,Total,5402,180,5582,2508,59,2567,1716,184,1900,10480,1366,11846,20106,1789,21895
2430,Tamilnadu,2003,Central Jail,5865,4,5869,3015,7,3022,1003,3,1006,6524,170,6694,16407,184,16591
2431,Tamilnadu,2003,District Jail,0,0,0,0,0,0,0,0,0,0,0,0,0,0,0
2432,Tamilnadu,2003,Sub_Jail,1,0,1,0,0,0,0,0,0,4152,478,4630,4153,478,4631
2433,Tamilnadu,2003,Women Jail,0,188,188,0,47,47,0,78,78,0,550,550,0,863,863
2434,Tamilnadu,2003,Borstal School,11,0,11,0,0,0,0,0,0,0,0,0,11,0,11
2435,Tamilnadu,2003,Open Jail,89,0,89,0,0,0,0,0,0,0,0,0,89,0,89
2436,Tamilnadu,2003,Special Jail,3,0,3,0,0,0,0,0,0,134,331,465,137,331,468
2437,Tamilnadu,2003,Others,0,0,0,0,0,0,0,0,0,0,0,0,0,0,0
2438,Tamilnadu,2003,Total,5969,192,6161,3015,54,3069,1003,81,1084,10810,1529,12339,20797,1856,22653
2439,Tamilnadu,2004,Central Jail,6495,1,6496,2855,14,2869,593,2,595,6166,83,6249,16109,100,16209
2440,Tamilnadu,2004,District Jail,0,0,0,0,0,0,0,0,0,0,0,0,0,0,0
2441,Tamilnadu,2004,Sub_Jail,0,0,0,4,0,4,0,0,0,2855,688,3543,2859,688,3547
2442,Tamilnadu,2004,Women Jail,0,200,200,0,45,45,0,17,17,0,566,566,0,828,828
2443,Tamilnadu,2004,Borstal School,9,0,9,0,0,0,0,0,0,0,0,0,9,0,9
2444,Tamilnadu,2004,Open Jail,89,0,89,0,0,0,0,0,0,0,0,0,89,0,89
2445,Tamilnadu,2004,Special Jail,0,0,0,0,0,0,0,0,0,197,214,411,197,214,411
2446,Tamilnadu,2004,Others,9,0,9,0,0,0,0,0,0,0,0,0,9,0,9
2447,Tamilnadu,2004,Total,6602,201,6803,2859,59,2918,593,19,612,9218,1551,10769,19272,1830,21102
2448,Tamilnadu,2005,Central Jail,7127,3,7130,2948,13,2961,787,2,789,4869,86,4955,15731,104,15835
2449,Tamilnadu,2005,District Jail,0,0,0,0,0,0,0,0,0,0,0,0,0,0,0
2450,Tamilnadu,2005,Sub_Jail,0,0,0,0,0,0,0,0,0,3106,621,3727,3106,621,3727
2451,Tamilnadu,2005,Women Jail,0,243,243,0,47,47,0,38,38,0,534,534,0,862,862
2452,Tamilnadu,2005,Borstal School,11,0,11,0,0,0,0,0,0,0,0,0,11,0,11
2453,Tamilnadu,2005,Open Jail,65,0,65,0,0,0,0,0,0,20,0,20,85,0,85
2454,Tamilnadu,2005,Special Jail,4,0,4,0,0,0,0,0,0,125,22,147,129,22,151
2455,Tamilnadu,2005,Others,10,0,10,0,0,0,0,0,0,0,0,0,10,0,10
2456,Tamilnadu,2005,Total,7217,246,7463,2948,60,3008,787,40,827,8120,1263,9383,19072,1609,20681
2457,Tamilnadu,2006,Central Jail,6434,0,6434,2835,5,2840,622,0,622,4049,39,4088,13940,44,13984
2458,Tamilnadu,2006,District Jail,0,0,0,0,0,0,0,0,0,61,119,180,61,119,180
2459,Tamilnadu,2006,Sub_Jail,0,0,0,0,0,0,0,0,0,2749,502,3251,2749,502,3251
2460,Tamilnadu,2006,Women Jail,0,197,197,0,45,45,0,29,29,0,518,518,0,789,789
2461,Tamilnadu,2006,Borstal School,0,0,0,0,0,0,0,0,0,339,0,339,339,0,339
2462,Tamilnadu,2006,Open Jail,53,0,53,0,0,0,0,0,0,0,0,0,53,0,53
2463,Tamilnadu,2006,Special Jail,10,0,10,0,0,0,0,0,0,0,0,0,10,0,10
2464,Tamilnadu,2006,Others,12,0,12,0,0,0,0,0,0,38,0,38,50,0,50
2465,Tamilnadu,2006,Total,6509,197,6706,2835,50,2885,622,29,651,7236,1178,8414,17202,1454,18656
2466,Tamilnadu,2007,Central Jail,6123,3,6126,6190,46,6236,636,0,636,8,0,8,12957,49,13006
2467,Tamilnadu,2007,District Jail,0,0,0,444,0,444,0,0,0,0,0,0,444,0,444
2468,Tamilnadu,2007,Sub_Jail,0,0,0,1718,238,1956,0,0,0,0,0,0,1718,238,1956
2469,Tamilnadu,2007,Women Jail,0,189,189,0,606,606,0,29,29,0,0,0,0,824,824
2470,Tamilnadu,2007,Borstal School,7,0,7,131,0,131,2,0,2,0,0,0,140,0,140
2471,Tamilnadu,2007,Open Jail,59,0,59,0,0,0,0,0,0,0,0,0,59,0,59
2472,Tamilnadu,2007,Special Jail,1,0,1,65,104,169,0,0,0,0,0,0,66,104,170
2473,Tamilnadu,2007,Others,0,0,0,0,0,0,0,0,0,0,0,0,0,0,0
2474,Tamilnadu,2007,Total,6190,192,6382,8548,994,9542,638,29,667,8,0,8,15384,1215,16599
2475,Tamilnadu,2008,Central Jail,5142,1,5143,6350,48,6398,989,0,989,4,0,4,12485,49,12534
2476,Tamilnadu,2008,District Jail,0,0,0,365,0,365,0,0,0,0,0,0,365,0,365
2477,Tamilnadu,2008,Sub_Jail,0,0,0,1675,230,1905,0,0,0,0,0,0,1675,230,1905
2478,Tamilnadu,2008,Women Jail,0,173,173,0,507,507,0,32,32,0,0,0,0,712,712
2479,Tamilnadu,2008,Borstal School,58,0,58,491,0,491,14,0,14,0,0,0,563,0,563
2480,Tamilnadu,2008,Open Jail,45,0,45,0,0,0,0,0,0,0,0,0,45,0,45
2481,Tamilnadu,2008,Special Jail,0,0,0,0,80,80,0,0,0,0,0,0,0,80,80
2482,Tamilnadu,2008,Others,0,0,0,0,0,0,0,0,0,0,0,0,0,0,0
2483,Tamilnadu,2008,Total,5245,174,5419,8881,865,9746,1003,32,1035,4,0,4,15133,1071,16204
2484,Tamilnadu,2009,Central Jail,5121,1,5122,5359,70,5429,819,0,819,4,0,4,11303,71,11374
2485,Tamilnadu,2009,District Jail,0,0,0,571,0,571,0,0,0,0,0,0,571,0,571
2486,Tamilnadu,2009,Sub_Jail,0,0,0,1324,117,1441,0,0,0,0,0,0,1324,117,1441
2487,Tamilnadu,2009,Women Jail,0,177,177,0,312,312,0,16,16,0,1,1,0,506,506
2488,Tamilnadu,2009,Borstal School,7,0,7,330,0,330,0,0,0,0,0,0,337,0,337
2489,Tamilnadu,2009,Open Jail,55,0,55,0,0,0,0,0,0,0,0,0,55,0,55
2490,Tamilnadu,2009,Special Jail,0,0,0,0,76,76,0,0,0,0,0,0,0,76,76
2491,Tamilnadu,2009,Others,0,0,0,0,0,0,0,0,0,0,0,0,0,0,0
2492,Tamilnadu,2009,Total,5183,178,5361,7584,575,8159,819,16,835,4,1,5,13590,770,14360
2493,Tamilnadu,2010,Central Jail,5136,1,5137,5183,56,5239,801,0,801,3,0,3,11123,57,11180
2494,Tamilnadu,2010,District Jail,0,0,0,449,0,449,0,0,0,0,0,0,449,0,449
2495,Tamilnadu,2010,Sub_Jail,0,0,0,1179,120,1299,0,0,0,0,0,0,1179,120,1299
2496,Tamilnadu,2010,Women Jail,0,167,167,0,284,284,0,23,23,0,0,0,0,474,474
2497,Tamilnadu,2010,Borstal School,5,0,5,343,0,343,9,0,9,0,0,0,357,0,357
2498,Tamilnadu,2010,Open Jail,24,0,24,0,0,0,0,0,0,0,0,0,24,0,24
2499,Tamilnadu,2010,Special Jail,0,0,0,0,83,83,0,0,0,0,0,0,0,83,83
2500,Tamilnadu,2010,Others,0,0,0,0,0,0,0,0,0,0,0,0,0,0,0
2501,Tamilnadu,2010,Total,5165,168,5333,7154,543,7697,810,23,833,3,0,3,13132,734,13866
2502,Tamilnadu,2011,Central Jail,4955,0,4955,4760,55,4815,957,0,957,4,0,4,10676,55,10731
2503,Tamilnadu,2011,District Jail,1,0,1,611,0,611,0,0,0,0,0,0,612,0,612
2504,Tamilnadu,2011,Sub_Jail,0,0,0,1362,184,1546,0,0,0,0,0,0,1362,184,1546
2505,Tamilnadu,2011,Women Jail,0,175,175,0,277,277,0,21,21,0,0,0,0,473,473
2506,Tamilnadu,2011,Borstal School,3,0,3,375,0,375,5,0,5,0,0,0,383,0,383
2507,Tamilnadu,2011,Open Jail,66,0,66,0,0,0,0,0,0,0,0,0,66,0,66
2508,Tamilnadu,2011,Special Jail,0,0,0,0,58,58,0,0,0,0,0,0,0,58,58
2509,Tamilnadu,2011,Others,0,0,0,0,0,0,0,0,0,0,0,0,0,0,0
2510,Tamilnadu,2011,Total,5025,175,5200,7108,574,7682,962,21,983,4,0,4,13099,770,13869
2511,Tamilnadu,2012,Central Jail,4436,0,4436,5159,47,5206,501,0,501,0,0,0,10096,47,10143
2512,Tamilnadu,2012,District Jail,0,0,0,613,0,613,0,0,0,0,0,0,613,0,613
2513,Tamilnadu,2012,Sub_Jail,0,0,0,1355,154,1509,0,0,0,0,0,0,1355,154,1509
2514,Tamilnadu,2012,Women Jail,0,168,168,0,293,293,0,21,21,0,0,0,0,482,482
2515,Tamilnadu,2012,Borstal School,11,0,11,309,0,309,1,0,1,0,0,0,321,0,321
2516,Tamilnadu,2012,Open Jail,63,0,63,0,0,0,0,0,0,0,0,0,63,0,63
2517,Tamilnadu,2012,Special Jail,0,0,0,0,64,64,0,0,0,0,0,0,0,64,64
2518,Tamilnadu,2012,Others,0,0,0,0,0,0,0,0,0,0,0,0,0,0,0
2519,Tamilnadu,2012,Total,4510,168,4678,7436,558,7994,502,21,523,0,0,0,12448,747,13195
2520,Tripura,2001,Central Jail,316,0,316,136,0,136,1,0,1,0,0,0,453,0,453
2521,Tripura,2001,District Jail,14,0,14,248,0,248,0,0,0,0,0,0,262,0,262
2522,Tripura,2001,Sub_Jail,28,0,28,280,3,283,1,0,1,0,0,0,309,3,312
2523,Tripura,2001,Women Jail,0,4,4,0,9,9,0,0,0,0,0,0,0,13,13
2524,Tripura,2001,Borstal School,0,0,0,0,0,0,0,0,0,0,0,0,0,0,0
2525,Tripura,2001,Open Jail,0,0,0,0,0,0,0,0,0,0,0,0,0,0,0
2526,Tripura,2001,Special Jail,0,0,0,0,0,0,0,0,0,0,0,0,0,0,0
2527,Tripura,2001,Others,0,0,0,0,0,0,0,0,0,0,0,0,0,0,0
2528,Tripura,2001,Total,358,4,362,664,12,676,2,0,2,0,0,0,1024,16,1040
2529,Tripura,2002,Central Jail,447,0,447,152,0,152,0,0,0,0,0,0,599,0,599
2530,Tripura,2002,District Jail,19,0,19,121,4,125,0,0,0,0,0,0,140,4,144
2531,Tripura,2002,Sub_Jail,16,0,16,270,0,270,2,0,2,0,0,0,288,0,288
2532,Tripura,2002,Women Jail,0,6,6,0,4,4,0,0,0,0,0,0,0,10,10
2533,Tripura,2002,Borstal School,0,0,0,0,0,0,0,0,0,0,0,0,0,0,0
2534,Tripura,2002,Open Jail,0,0,0,0,0,0,0,0,0,0,0,0,0,0,0
2535,Tripura,2002,Special Jail,0,0,0,0,0,0,0,0,0,0,0,0,0,0,0
2536,Tripura,2002,Others,0,0,0,0,0,0,0,0,0,0,0,0,0,0,0
2537,Tripura,2002,Total,482,6,488,543,8,551,2,0,2,0,0,0,1027,14,1041
2538,Tripura,2003,Central Jail,274,0,274,201,0,201,0,0,0,1,0,1,476,0,476
2539,Tripura,2003,District Jail,102,0,102,170,0,170,0,0,0,0,0,0,272,0,272
2540,Tripura,2003,Sub_Jail,117,0,117,516,6,522,2,0,2,0,0,0,635,6,641
2541,Tripura,2003,Women Jail,0,7,7,0,5,5,0,0,0,0,0,0,0,12,12
2542,Tripura,2003,Borstal School,0,0,0,0,0,0,0,0,0,0,0,0,0,0,0
2543,Tripura,2003,Open Jail,0,0,0,0,0,0,0,0,0,0,0,0,0,0,0
2544,Tripura,2003,Special Jail,0,0,0,0,0,0,0,0,0,0,0,0,0,0,0
2545,Tripura,2003,Others,0,0,0,0,0,0,0,0,0,0,0,0,0,0,0
2546,Tripura,2003,Total,493,7,500,887,11,898,2,0,2,1,0,1,1383,18,1401
2547,Tripura,2004,Central Jail,351,0,351,159,0,159,0,0,0,0,0,0,510,0,510
2548,Tripura,2004,District Jail,97,0,97,157,3,160,0,0,0,1,0,1,255,3,258
2549,Tripura,2004,Sub_Jail,92,0,92,382,3,385,0,0,0,2,0,2,476,3,479
2550,Tripura,2004,Women Jail,0,14,14,0,4,4,0,0,0,0,0,0,0,18,18
2551,Tripura,2004,Borstal School,0,0,0,0,0,0,0,0,0,0,0,0,0,0,0
2552,Tripura,2004,Open Jail,0,0,0,0,0,0,0,0,0,0,0,0,0,0,0
2553,Tripura,2004,Special Jail,0,0,0,0,0,0,0,0,0,0,0,0,0,0,0
2554,Tripura,2004,Others,0,0,0,0,0,0,0,0,0,0,0,0,0,0,0
2555,Tripura,2004,Total,540,14,554,698,10,708,0,0,0,3,0,3,1241,24,1265
2556,Tripura,2005,Central Jail,512,0,512,167,0,167,1,0,1,1,0,1,681,0,681
2557,Tripura,2005,District Jail,105,0,105,116,6,122,0,0,0,0,0,0,221,6,227
2558,Tripura,2005,Sub_Jail,120,0,120,352,11,363,0,0,0,0,0,0,472,11,483
2559,Tripura,2005,Women Jail,0,15,15,0,4,4,0,0,0,0,0,0,0,19,19
2560,Tripura,2005,Borstal School,0,0,0,0,0,0,0,0,0,0,0,0,0,0,0
2561,Tripura,2005,Open Jail,0,0,0,0,0,0,0,0,0,0,0,0,0,0,0
2562,Tripura,2005,Special Jail,0,0,0,0,0,0,0,0,0,0,0,0,0,0,0
2563,Tripura,2005,Others,0,0,0,0,0,0,0,0,0,0,0,0,0,0,0
2564,Tripura,2005,Total,737,15,752,635,21,656,1,0,1,1,0,1,1374,36,1410
2565,Tripura,2006,Central Jail,556,0,556,137,0,137,0,0,0,0,0,0,693,0,693
2566,Tripura,2006,District Jail,115,0,115,85,3,88,0,0,0,0,0,0,200,3,203
2567,Tripura,2006,Sub_Jail,100,1,101,344,7,351,0,0,0,0,0,0,444,8,452
2568,Tripura,2006,Women Jail,0,17,17,0,5,5,0,0,0,0,0,0,0,22,22
2569,Tripura,2006,Borstal School,0,0,0,0,0,0,0,0,0,0,0,0,0,0,0
2570,Tripura,2006,Open Jail,0,0,0,0,0,0,0,0,0,0,0,0,0,0,0
2571,Tripura,2006,Special Jail,0,0,0,0,0,0,0,0,0,0,0,0,0,0,0
2572,Tripura,2006,Others,0,0,0,0,0,0,0,0,0,0,0,0,0,0,0
2573,Tripura,2006,Total,771,18,789,566,15,581,0,0,0,0,0,0,1337,33,1370
2574,Tripura,2007,Central Jail,533,0,533,137,0,137,0,0,0,0,0,0,670,0,670
2575,Tripura,2007,District Jail,161,1,162,62,0,62,1,0,1,0,0,0,224,1,225
2576,Tripura,2007,Sub_Jail,96,1,97,290,6,296,0,0,0,0,0,0,386,7,393
2577,Tripura,2007,Women Jail,0,21,21,0,8,8,0,0,0,0,0,0,0,29,29
2578,Tripura,2007,Borstal School,0,0,0,0,0,0,0,0,0,0,0,0,0,0,0
2579,Tripura,2007,Open Jail,0,0,0,0,0,0,0,0,0,0,0,0,0,0,0
2580,Tripura,2007,Special Jail,0,0,0,0,0,0,0,0,0,0,0,0,0,0,0
2581,Tripura,2007,Others,0,0,0,0,0,0,0,0,0,0,0,0,0,0,0
2582,Tripura,2007,Total,790,23,813,489,14,503,1,0,1,0,0,0,1280,37,1317
2583,Tripura,2008,Central Jail,531,0,531,140,0,140,0,0,0,0,0,0,671,0,671
2584,Tripura,2008,District Jail,177,0,177,77,1,78,0,0,0,0,0,0,254,1,255
2585,Tripura,2008,Sub_Jail,100,0,100,226,4,230,0,0,0,0,0,0,326,4,330
2586,Tripura,2008,Women Jail,0,19,19,0,3,3,0,0,0,0,0,0,0,22,22
2587,Tripura,2008,Borstal School,0,0,0,0,0,0,0,0,0,0,0,0,0,0,0
2588,Tripura,2008,Open Jail,0,0,0,0,0,0,0,0,0,0,0,0,0,0,0
2589,Tripura,2008,Special Jail,0,0,0,0,0,0,0,0,0,0,0,0,0,0,0
2590,Tripura,2008,Others,0,0,0,0,0,0,0,0,0,0,0,0,0,0,0
2591,Tripura,2008,Total,808,19,827,443,8,451,0,0,0,0,0,0,1251,27,1278
2592,Tripura,2009,Central Jail,382,0,382,117,0,117,0,0,0,0,0,0,499,0,499
2593,Tripura,2009,District Jail,147,0,147,69,4,73,0,0,0,0,0,0,216,4,220
2594,Tripura,2009,Sub_Jail,110,1,111,133,8,141,0,0,0,0,0,0,243,9,252
2595,Tripura,2009,Women Jail,0,13,13,0,4,4,0,0,0,0,0,0,0,17,17
2596,Tripura,2009,Borstal School,0,0,0,0,0,0,0,0,0,0,0,0,0,0,0
2597,Tripura,2009,Open Jail,0,0,0,0,0,0,0,0,0,0,0,0,0,0,0
2598,Tripura,2009,Special Jail,0,0,0,0,0,0,0,0,0,0,0,0,0,0,0
2599,Tripura,2009,Others,0,0,0,0,0,0,0,0,0,0,0,0,0,0,0
2600,Tripura,2009,Total,639,14,653,319,16,335,0,0,0,0,0,0,958,30,988
2601,Tripura,2010,Central Jail,329,0,329,121,0,121,0,0,0,0,0,0,450,0,450
2602,Tripura,2010,District Jail,108,0,108,44,3,47,0,0,0,0,0,0,152,3,155
2603,Tripura,2010,Sub_Jail,154,1,155,173,6,179,0,0,0,0,0,0,327,7,334
2604,Tripura,2010,Women Jail,0,11,11,0,1,1,0,0,0,0,0,0,0,12,12
2605,Tripura,2010,Borstal School,0,0,0,0,0,0,0,0,0,0,0,0,0,0,0
2606,Tripura,2010,Open Jail,0,0,0,0,0,0,0,0,0,0,0,0,0,0,0
2607,Tripura,2010,Special Jail,0,0,0,0,0,0,0,0,0,0,0,0,0,0,0
2608,Tripura,2010,Others,0,0,0,0,0,0,0,0,0,0,0,0,0,0,0
2609,Tripura,2010,Total,591,12,603,338,10,348,0,0,0,0,0,0,929,22,951
2610,Tripura,2011,Central Jail,314,0,314,110,0,110,0,0,0,0,0,0,424,0,424
2611,Tripura,2011,District Jail,123,0,123,44,2,46,0,0,0,0,0,0,167,2,169
2612,Tripura,2011,Sub_Jail,117,1,118,156,7,163,0,0,0,0,0,0,273,8,281
2613,Tripura,2011,Women Jail,0,14,14,0,11,11,0,0,0,0,0,0,0,25,25
2614,Tripura,2011,Borstal School,0,0,0,0,0,0,0,0,0,0,0,0,0,0,0
2615,Tripura,2011,Open Jail,0,0,0,0,0,0,0,0,0,0,0,0,0,0,0
2616,Tripura,2011,Special Jail,0,0,0,0,0,0,0,0,0,0,0,0,0,0,0
2617,Tripura,2011,Others,0,0,0,0,0,0,0,0,0,0,0,0,0,0,0
2618,Tripura,2011,Total,554,15,569,310,20,330,0,0,0,0,0,0,864,35,899
2619,Tripura,2012,Central Jail,307,0,307,119,0,119,0,0,0,0,0,0,426,0,426
2620,Tripura,2012,District Jail,113,0,113,47,0,47,0,0,0,0,0,0,160,0,160
2621,Tripura,2012,Sub_Jail,115,1,116,172,2,174,0,0,0,0,0,0,287,3,290
2622,Tripura,2012,Women Jail,0,13,13,0,12,12,0,0,0,0,0,0,0,25,25
2623,Tripura,2012,Borstal School,0,0,0,0,0,0,0,0,0,0,0,0,0,0,0
2624,Tripura,2012,Open Jail,0,0,0,0,0,0,0,0,0,0,0,0,0,0,0
2625,Tripura,2012,Special Jail,0,0,0,0,0,0,0,0,0,0,0,0,0,0,0
2626,Tripura,2012,Others,0,0,0,0,0,0,0,0,0,0,0,0,0,0,0
2627,Tripura,2012,Total,535,14,549,338,14,352,0,0,0,0,0,0,873,28,901
2628,Uttar Pradesh,2001,Central Jail,3347,6,3353,3655,47,3702,29,0,29,2,0,2,7033,53,7086
2629,Uttar Pradesh,2001,District Jail,1896,17,1913,41471,1121,42592,290,5,295,313,4,317,43970,1147,45117
2630,Uttar Pradesh,2001,Sub_Jail,22,0,22,572,9,581,185,1,186,24,0,24,803,10,813
2631,Uttar Pradesh,2001,Women Jail,0,18,18,0,0,0,0,0,0,0,0,0,0,18,18
2632,Uttar Pradesh,2001,Borstal School,0,0,0,0,0,0,0,0,0,0,0,0,0,0,0
2633,Uttar Pradesh,2001,Open Jail,0,0,0,0,0,0,0,0,0,0,0,0,0,0,0
2634,Uttar Pradesh,2001,Special Jail,160,102,262,0,0,0,0,0,0,0,0,0,160,102,262
2635,Uttar Pradesh,2001,Others,0,0,0,0,0,0,0,0,0,0,0,0,0,0,0
2636,Uttar Pradesh,2001,Total,5425,143,5568,45698,1177,46875,504,6,510,339,4,343,51966,1330,53296
2637,Uttar Pradesh,2002,Central Jail,3665,6,3671,1947,29,1976,119,0,119,15,0,15,5746,35,5781
2638,Uttar Pradesh,2002,District Jail,1996,25,2021,41533,1059,42592,940,5,945,41,0,41,44510,1089,45599
2639,Uttar Pradesh,2002,Sub_Jail,26,0,26,336,12,348,11,2,13,67,0,67,440,14,454
2640,Uttar Pradesh,2002,Women Jail,0,126,126,0,0,0,0,0,0,0,0,0,0,126,126
2641,Uttar Pradesh,2002,Borstal School,0,0,0,0,0,0,0,0,0,0,0,0,0,0,0
2642,Uttar Pradesh,2002,Open Jail,0,0,0,0,0,0,0,0,0,0,0,0,0,0,0
2643,Uttar Pradesh,2002,Special Jail,229,0,229,35,0,35,1,0,1,0,0,0,265,0,265
2644,Uttar Pradesh,2002,Others,0,0,0,0,0,0,0,0,0,0,0,0,0,0,0
2645,Uttar Pradesh,2002,Total,5916,157,6073,43851,1100,44951,1071,7,1078,123,0,123,50961,1264,52225
2646,Uttar Pradesh,2003,Central Jail,3954,4,3958,2311,12,2323,23,0,23,19,0,19,6307,16,6323
2647,Uttar Pradesh,2003,District Jail,2861,32,2893,38053,912,38965,1375,19,1394,164,0,164,42453,963,43416
2648,Uttar Pradesh,2003,Sub_Jail,23,0,23,420,2,422,0,0,0,32,0,32,475,2,477
2649,Uttar Pradesh,2003,Women Jail,0,140,140,0,0,0,0,0,0,0,0,0,0,140,140
2650,Uttar Pradesh,2003,Borstal School,0,0,0,0,0,0,0,0,0,0,0,0,0,0,0
2651,Uttar Pradesh,2003,Open Jail,0,0,0,0,0,0,0,0,0,0,0,0,0,0,0
2652,Uttar Pradesh,2003,Special Jail,175,0,175,0,0,0,0,0,0,0,0,0,175,0,175
2653,Uttar Pradesh,2003,Others,0,0,0,0,0,0,0,0,0,0,0,0,0,0,0
2654,Uttar Pradesh,2003,Total,7013,176,7189,40784,926,41710,1398,19,1417,215,0,215,49410,1121,50531
2655,Uttar Pradesh,2004,Central Jail,4737,6,4743,2140,23,2163,12,0,12,23,0,23,6912,29,6941
2656,Uttar Pradesh,2004,District Jail,3123,184,3307,37746,750,38496,1968,73,2041,94,1,95,42931,1008,43939
2657,Uttar Pradesh,2004,Sub_Jail,41,1,42,457,4,461,0,0,0,0,0,0,498,5,503
2658,Uttar Pradesh,2004,Women Jail,0,6,6,0,104,104,0,0,0,0,0,0,0,110,110
2659,Uttar Pradesh,2004,Borstal School,0,0,0,0,0,0,0,0,0,0,0,0,0,0,0
2660,Uttar Pradesh,2004,Open Jail,0,0,0,0,0,0,0,0,0,0,0,0,0,0,0
2661,Uttar Pradesh,2004,Special Jail,213,0,213,0,0,0,0,0,0,0,0,0,213,0,213
2662,Uttar Pradesh,2004,Others,0,0,0,0,0,0,0,0,0,0,0,0,0,0,0
2663,Uttar Pradesh,2004,Total,8114,197,8311,40343,881,41224,1980,73,2053,117,1,118,50554,1152,51706
2664,Uttar Pradesh,2005,Central Jail,7192,6,7198,1369,27,1396,22,0,22,6,0,6,8589,33,8622
2665,Uttar Pradesh,2005,District Jail,5497,162,5659,40230,1019,41249,203,1,204,91,0,91,46021,1182,47203
2666,Uttar Pradesh,2005,Sub_Jail,36,0,36,407,3,410,21,0,21,10,0,10,474,3,477
2667,Uttar Pradesh,2005,Women Jail,0,125,125,0,0,0,0,0,0,0,0,0,0,125,125
2668,Uttar Pradesh,2005,Borstal School,0,0,0,0,0,0,0,0,0,0,0,0,0,0,0
2669,Uttar Pradesh,2005,Open Jail,0,0,0,0,0,0,0,0,0,0,0,0,0,0,0
2670,Uttar Pradesh,2005,Special Jail,266,0,266,23,0,23,2,0,2,0,0,0,291,0,291
2671,Uttar Pradesh,2005,Others,0,0,0,0,0,0,0,0,0,0,0,0,0,0,0
2672,Uttar Pradesh,2005,Total,12991,293,13284,42029,1049,43078,248,1,249,107,0,107,55375,1343,56718
2673,Uttar Pradesh,2006,Central Jail,9797,9,9806,1707,47,1754,31,0,31,0,0,0,11535,56,11591
2674,Uttar Pradesh,2006,District Jail,5709,291,6000,46373,1408,47781,160,1,161,24,0,24,52266,1700,53966
2675,Uttar Pradesh,2006,Sub_Jail,73,2,75,593,14,607,0,0,0,0,0,0,666,16,682
2676,Uttar Pradesh,2006,Women Jail,0,175,175,0,0,0,0,0,0,0,0,0,0,175,175
2677,Uttar Pradesh,2006,Borstal School,0,0,0,0,0,0,0,0,0,0,0,0,0,0,0
2678,Uttar Pradesh,2006,Open Jail,0,0,0,0,0,0,0,0,0,0,0,0,0,0,0
2679,Uttar Pradesh,2006,Special Jail,233,0,233,21,0,21,1,0,1,0,0,0,255,0,255
2680,Uttar Pradesh,2006,Others,0,0,0,0,0,0,0,0,0,0,0,0,0,0,0
2681,Uttar Pradesh,2006,Total,15812,477,16289,48694,1469,50163,192,1,193,24,0,24,64722,1947,66669
2682,Uttar Pradesh,2007,Central Jail,12323,13,12336,2332,67,2399,57,0,57,0,0,0,14712,80,14792
2683,Uttar Pradesh,2007,District Jail,6346,408,6754,49415,1619,51034,2185,53,2238,193,1,194,58139,2081,60220
2684,Uttar Pradesh,2007,Sub_Jail,127,3,130,549,10,559,1,0,1,4,0,4,681,13,694
2685,Uttar Pradesh,2007,Women Jail,0,155,155,0,0,0,0,0,0,0,0,0,0,155,155
2686,Uttar Pradesh,2007,Borstal School,0,0,0,0,0,0,0,0,0,0,0,0,0,0,0
2687,Uttar Pradesh,2007,Open Jail,0,0,0,0,0,0,0,0,0,0,0,0,0,0,0
2688,Uttar Pradesh,2007,Special Jail,318,0,318,0,0,0,1,0,1,0,0,0,319,0,319
2689,Uttar Pradesh,2007,Others,0,0,0,0,0,0,0,0,0,0,0,0,0,0,0
2690,Uttar Pradesh,2007,Total,19114,579,19693,52296,1696,53992,2244,53,2297,197,1,198,73851,2329,76180
2691,Uttar Pradesh,2008,Central Jail,12139,17,12156,2060,71,2131,106,0,106,0,0,0,14305,88,14393
2692,Uttar Pradesh,2008,District Jail,8401,497,8898,53873,1936,55809,499,0,499,26,1,27,62799,2434,65233
2693,Uttar Pradesh,2008,Sub_Jail,143,5,148,545,13,558,3,0,3,1,0,1,692,18,710
2694,Uttar Pradesh,2008,Women Jail,0,154,154,0,0,0,0,0,0,0,0,0,0,154,154
2695,Uttar Pradesh,2008,Borstal School,0,0,0,0,0,0,0,0,0,0,0,0,0,0,0
2696,Uttar Pradesh,2008,Open Jail,0,0,0,0,0,0,0,0,0,0,0,0,0,0,0
2697,Uttar Pradesh,2008,Special Jail,319,0,319,0,0,0,0,0,0,0,0,0,319,0,319
2698,Uttar Pradesh,2008,Others,0,0,0,0,0,0,0,0,0,0,0,0,0,0,0
2699,Uttar Pradesh,2008,Total,21002,673,21675,56478,2020,58498,608,0,608,27,1,28,78115,2694,80809
2700,Uttar Pradesh,2009,Central Jail,11123,22,11145,1995,69,2064,82,0,82,7,0,7,13207,91,13298
2701,Uttar Pradesh,2009,District Jail,12041,467,12508,54513,1956,56469,207,2,209,16,0,16,66777,2425,69202
2702,Uttar Pradesh,2009,Sub_Jail,173,8,181,509,16,525,3,0,3,0,0,0,685,24,709
2703,Uttar Pradesh,2009,Women Jail,0,219,219,0,0,0,0,0,0,0,0,0,0,219,219
2704,Uttar Pradesh,2009,Borstal School,0,0,0,0,0,0,0,0,0,0,0,0,0,0,0
2705,Uttar Pradesh,2009,Open Jail,0,0,0,0,0,0,0,0,0,0,0,0,0,0,0
2706,Uttar Pradesh,2009,Special Jail,377,0,377,0,0,0,0,0,0,0,0,0,377,0,377
2707,Uttar Pradesh,2009,Others,0,0,0,0,0,0,0,0,0,0,0,0,0,0,0
2708,Uttar Pradesh,2009,Total,23714,716,24430,57017,2041,59058,292,2,294,23,0,23,81046,2759,83805
2709,Uttar Pradesh,2010,Central Jail,12739,30,12769,2125,57,2182,23,0,23,0,0,0,14887,87,14974
2710,Uttar Pradesh,2010,District Jail,12469,420,12889,51402,1769,53171,212,0,212,30,0,30,64113,2189,66302
2711,Uttar Pradesh,2010,Sub_Jail,121,7,128,513,6,519,3,0,3,0,0,0,637,13,650
2712,Uttar Pradesh,2010,Women Jail,0,342,342,0,0,0,0,0,0,0,0,0,0,342,342
2713,Uttar Pradesh,2010,Borstal School,0,0,0,0,0,0,0,0,0,0,0,0,0,0,0
2714,Uttar Pradesh,2010,Open Jail,0,0,0,0,0,0,0,0,0,0,0,0,0,0,0
2715,Uttar Pradesh,2010,Special Jail,405,0,405,0,0,0,0,0,0,0,0,0,405,0,405
2716,Uttar Pradesh,2010,Others,0,0,0,0,0,0,0,0,0,0,0,0,0,0,0
2717,Uttar Pradesh,2010,Total,25734,799,26533,54040,1832,55872,238,0,238,30,0,30,80042,2631,82673
2718,Uttar Pradesh,2011,Central Jail,11870,28,11898,1913,76,1989,9,0,9,0,0,0,13792,104,13896
2719,Uttar Pradesh,2011,District Jail,14737,570,15307,49335,2044,51379,201,0,201,57,0,57,64330,2614,66944
2720,Uttar Pradesh,2011,Sub_Jail,139,8,147,580,28,608,3,0,3,0,0,0,722,36,758
2721,Uttar Pradesh,2011,Women Jail,0,299,299,0,86,86,0,0,0,0,0,0,0,385,385
2722,Uttar Pradesh,2011,Borstal School,0,0,0,0,0,0,0,0,0,0,0,0,0,0,0
2723,Uttar Pradesh,2011,Open Jail,0,0,0,0,0,0,0,0,0,0,0,0,0,0,0
2724,Uttar Pradesh,2011,Special Jail,400,0,400,0,0,0,0,0,0,0,0,0,400,0,400
2725,Uttar Pradesh,2011,Others,0,0,0,0,0,0,0,0,0,0,0,0,0,0,0
2726,Uttar Pradesh,2011,Total,27146,905,28051,51828,2234,54062,213,0,213,57,0,57,79244,3139,82383
2727,Uttar Pradesh,2012,Central Jail,10686,22,10708,2064,78,2142,6,0,6,2,0,2,12758,100,12858
2728,Uttar Pradesh,2012,District Jail,14224,558,14782,48794,2162,50956,191,0,191,39,0,39,63248,2720,65968
2729,Uttar Pradesh,2012,Sub_Jail,99,8,107,639,29,668,0,0,0,2,0,2,740,37,777
2730,Uttar Pradesh,2012,Women Jail,0,256,256,0,50,50,0,0,0,0,0,0,0,306,306
2731,Uttar Pradesh,2012,Borstal School,0,0,0,0,0,0,0,0,0,0,0,0,0,0,0
2732,Uttar Pradesh,2012,Open Jail,0,0,0,0,0,0,0,0,0,0,0,0,0,0,0
2733,Uttar Pradesh,2012,Special Jail,397,0,397,5,0,5,0,0,0,0,0,0,402,0,402
2734,Uttar Pradesh,2012,Others,0,0,0,0,0,0,0,0,0,0,0,0,0,0,0
2735,Uttar Pradesh,2012,Total,25406,844,26250,51502,2319,53821,197,0,197,43,0,43,77148,3163,80311
2736,Uttaranchal,2001,Central Jail,0,0,0,0,0,0,0,0,0,0,0,0,0,0,0
2737,Uttaranchal,2001,District Jail,127,1,128,913,36,949,0,0,0,0,0,0,1040,37,1077
2738,Uttaranchal,2001,Sub_Jail,121,2,123,805,27,832,0,0,0,0,0,0,926,29,955
2739,Uttaranchal,2001,Women Jail,0,0,0,0,0,0,0,0,0,0,0,0,0,0,0
2740,Uttaranchal,2001,Borstal School,0,0,0,0,0,0,0,0,0,0,0,0,0,0,0
2741,Uttaranchal,2001,Open Jail,258,0,258,0,0,0,0,0,0,0,0,0,258,0,258
2742,Uttaranchal,2001,Special Jail,0,0,0,0,0,0,0,0,0,0,0,0,0,0,0
2743,Uttaranchal,2001,Others,0,0,0,0,0,0,0,0,0,0,0,0,0,0,0
2744,Uttaranchal,2001,Total,506,3,509,1718,63,1781,0,0,0,0,0,0,2224,66,2290
2745,Uttaranchal,2002,Central Jail,0,0,0,0,0,0,0,0,0,0,0,0,0,0,0
2746,Uttaranchal,2002,District Jail,259,8,267,1014,27,1041,0,0,0,0,0,0,1273,35,1308
2747,Uttaranchal,2002,Sub_Jail,116,4,120,638,23,661,0,0,0,0,0,0,754,27,781
2748,Uttaranchal,2002,Women Jail,0,0,0,0,0,0,0,0,0,0,0,0,0,0,0
2749,Uttaranchal,2002,Borstal School,0,0,0,0,0,0,0,0,0,0,0,0,0,0,0
2750,Uttaranchal,2002,Open Jail,270,0,270,0,0,0,0,0,0,0,0,0,270,0,270
2751,Uttaranchal,2002,Special Jail,0,0,0,0,0,0,0,0,0,0,0,0,0,0,0
2752,Uttaranchal,2002,Others,0,0,0,0,0,0,0,0,0,0,0,0,0,0,0
2753,Uttaranchal,2002,Total,645,12,657,1652,50,1702,0,0,0,0,0,0,2297,62,2359
2754,Uttaranchal,2003,Central Jail,0,0,0,0,0,0,0,0,0,0,0,0,0,0,0
2755,Uttaranchal,2003,District Jail,389,11,400,972,28,1000,1,0,1,0,0,0,1362,39,1401
2756,Uttaranchal,2003,Sub_Jail,52,1,53,700,19,719,4,0,4,2,0,2,758,20,778
2757,Uttaranchal,2003,Women Jail,0,0,0,0,0,0,0,0,0,0,0,0,0,0,0
2758,Uttaranchal,2003,Borstal School,0,0,0,0,0,0,0,0,0,0,0,0,0,0,0
2759,Uttaranchal,2003,Open Jail,252,0,252,0,0,0,0,0,0,0,0,0,252,0,252
2760,Uttaranchal,2003,Special Jail,0,0,0,0,0,0,0,0,0,0,0,0,0,0,0
2761,Uttaranchal,2003,Others,0,0,0,0,0,0,0,0,0,0,0,0,0,0,0
2762,Uttaranchal,2003,Total,693,12,705,1672,47,1719,5,0,5,2,0,2,2372,59,2431
2763,Uttaranchal,2004,Central Jail,0,0,0,0,0,0,0,0,0,0,0,0,0,0,0
2764,Uttaranchal,2004,District Jail,373,16,389,877,65,942,2,0,2,0,0,0,1252,81,1333
2765,Uttaranchal,2004,Sub_Jail,46,5,51,650,18,668,3,0,3,0,0,0,699,23,722
2766,Uttaranchal,2004,Women Jail,0,0,0,0,0,0,0,0,0,0,0,0,0,0,0
2767,Uttaranchal,2004,Borstal School,0,0,0,0,0,0,0,0,0,0,0,0,0,0,0
2768,Uttaranchal,2004,Open Jail,310,0,310,0,0,0,0,0,0,0,0,0,310,0,310
2769,Uttaranchal,2004,Special Jail,0,0,0,0,0,0,0,0,0,0,0,0,0,0,0
2770,Uttaranchal,2004,Others,0,0,0,0,0,0,0,0,0,0,0,0,0,0,0
2771,Uttaranchal,2004,Total,729,21,750,1527,83,1610,5,0,5,0,0,0,2261,104,2365
2772,Uttaranchal,2005,Central Jail,0,0,0,0,0,0,0,0,0,0,0,0,0,0,0
2773,Uttaranchal,2005,District Jail,399,14,413,867,22,889,0,0,0,5,0,5,1271,36,1307
2774,Uttaranchal,2005,Sub_Jail,48,0,48,677,12,689,2,0,2,0,0,0,727,12,739
2775,Uttaranchal,2005,Women Jail,0,0,0,0,0,0,0,0,0,0,0,0,0,0,0
2776,Uttaranchal,2005,Borstal School,0,0,0,0,0,0,0,0,0,0,0,0,0,0,0
2777,Uttaranchal,2005,Open Jail,304,0,304,0,0,0,0,0,0,0,0,0,304,0,304
2778,Uttaranchal,2005,Special Jail,0,0,0,0,0,0,0,0,0,0,0,0,0,0,0
2779,Uttaranchal,2005,Others,0,0,0,0,0,0,0,0,0,0,0,0,0,0,0
2780,Uttaranchal,2005,Total,751,14,765,1544,34,1578,2,0,2,5,0,5,2302,48,2350
2781,Uttaranchal,2006,Central Jail,0,0,0,0,0,0,0,0,0,0,0,0,0,0,0
2782,Uttaranchal,2006,District Jail,613,16,629,921,29,950,0,0,0,0,0,0,1534,45,1579
2783,Uttaranchal,2006,Sub_Jail,42,1,43,764,23,787,0,0,0,0,0,0,806,24,830
2784,Uttaranchal,2006,Women Jail,0,0,0,0,0,0,0,0,0,0,0,0,0,0,0
2785,Uttaranchal,2006,Borstal School,0,0,0,0,0,0,0,0,0,0,0,0,0,0,0
2786,Uttaranchal,2006,Open Jail,235,0,235,0,0,0,0,0,0,0,0,0,235,0,235
2787,Uttaranchal,2006,Special Jail,0,0,0,0,0,0,0,0,0,0,0,0,0,0,0
2788,Uttaranchal,2006,Others,0,0,0,0,0,0,0,0,0,0,0,0,0,0,0
2789,Uttaranchal,2006,Total,890,17,907,1685,52,1737,0,0,0,0,0,0,2575,69,2644
2790,Uttaranchal,2007,Central Jail,0,0,0,0,0,0,0,0,0,0,0,0,0,0,0
2791,Uttaranchal,2007,District Jail,758,27,785,866,31,897,0,0,0,0,0,0,1624,58,1682
2792,Uttaranchal,2007,Sub_Jail,42,1,43,741,23,764,0,0,0,0,0,0,783,24,807
2793,Uttaranchal,2007,Women Jail,0,0,0,0,0,0,0,0,0,0,0,0,0,0,0
2794,Uttaranchal,2007,Borstal School,0,0,0,0,0,0,0,0,0,0,0,0,0,0,0
2795,Uttaranchal,2007,Open Jail,220,0,220,0,0,0,0,0,0,0,0,0,220,0,220
2796,Uttaranchal,2007,Special Jail,0,0,0,0,0,0,0,0,0,0,0,0,0,0,0
2797,Uttaranchal,2007,Others,0,0,0,0,0,0,0,0,0,0,0,0,0,0,0
2798,Uttaranchal,2007,Total,1020,28,1048,1607,54,1661,0,0,0,0,0,0,2627,82,2709
2799,Uttaranchal,2008,Central Jail,0,0,0,0,0,0,0,0,0,0,0,0,0,0,0
2800,Uttaranchal,2008,District Jail,942,34,976,1045,51,1096,0,0,0,0,0,0,1987,85,2072
2801,Uttaranchal,2008,Sub_Jail,32,1,33,882,34,916,0,0,0,0,0,0,914,35,949
2802,Uttaranchal,2008,Women Jail,0,0,0,0,0,0,0,0,0,0,0,0,0,0,0
2803,Uttaranchal,2008,Borstal School,0,0,0,0,0,0,0,0,0,0,0,0,0,0,0
2804,Uttaranchal,2008,Open Jail,213,0,213,0,0,0,0,0,0,0,0,0,213,0,213
2805,Uttaranchal,2008,Special Jail,0,0,0,0,0,0,0,0,0,0,0,0,0,0,0
2806,Uttaranchal,2008,Others,0,0,0,0,0,0,0,0,0,0,0,0,0,0,0
2807,Uttaranchal,2008,Total,1187,35,1222,1927,85,2012,0,0,0,0,0,0,3114,120,3234
2808,Uttaranchal,2009,Central Jail,0,0,0,0,0,0,0,0,0,0,0,0,0,0,0
2809,Uttaranchal,2009,District Jail,997,43,1040,1191,44,1235,0,0,0,0,0,0,2188,87,2275
2810,Uttaranchal,2009,Sub_Jail,44,1,45,957,32,989,0,0,0,0,0,0,1001,33,1034
2811,Uttaranchal,2009,Women Jail,0,0,0,0,0,0,0,0,0,0,0,0,0,0,0
2812,Uttaranchal,2009,Borstal School,0,0,0,0,0,0,0,0,0,0,0,0,0,0,0
2813,Uttaranchal,2009,Open Jail,198,0,198,0,0,0,0,0,0,0,0,0,198,0,198
2814,Uttaranchal,2009,Special Jail,0,0,0,0,0,0,0,0,0,0,0,0,0,0,0
2815,Uttaranchal,2009,Others,0,0,0,0,0,0,0,0,0,0,0,0,0,0,0
2816,Uttaranchal,2009,Total,1239,44,1283,2148,76,2224,0,0,0,0,0,0,3387,120,3507
2817,Uttaranchal,2010,Central Jail,0,0,0,0,0,0,0,0,0,0,0,0,0,0,0
2818,Uttaranchal,2010,District Jail,1102,53,1155,1186,25,1211,0,0,0,0,0,0,2288,78,2366
2819,Uttaranchal,2010,Sub_Jail,85,3,88,843,33,876,0,0,0,0,0,0,928,36,964
2820,Uttaranchal,2010,Women Jail,0,0,0,0,0,0,0,0,0,0,0,0,0,0,0
2821,Uttaranchal,2010,Borstal School,0,0,0,0,0,0,0,0,0,0,0,0,0,0,0
2822,Uttaranchal,2010,Open Jail,213,0,213,0,0,0,0,0,0,0,0,0,213,0,213
2823,Uttaranchal,2010,Special Jail,0,0,0,0,0,0,0,0,0,0,0,0,0,0,0
2824,Uttaranchal,2010,Others,0,0,0,0,0,0,0,0,0,0,0,0,0,0,0
2825,Uttaranchal,2010,Total,1400,56,1456,2029,58,2087,0,0,0,0,0,0,3429,114,3543
2826,Uttaranchal,2011,Central Jail,19,0,19,0,0,0,0,0,0,0,0,0,19,0,19
2827,Uttaranchal,2011,District Jail,1217,66,1283,859,33,892,0,0,0,0,0,0,2076,99,2175
2828,Uttaranchal,2011,Sub_Jail,35,1,36,781,35,816,0,0,0,0,0,0,816,36,852
2829,Uttaranchal,2011,Women Jail,0,0,0,0,0,0,0,0,0,0,0,0,0,0,0
2830,Uttaranchal,2011,Borstal School,0,0,0,0,0,0,0,0,0,0,0,0,0,0,0
2831,Uttaranchal,2011,Open Jail,215,0,215,0,0,0,0,0,0,0,0,0,215,0,215
2832,Uttaranchal,2011,Special Jail,0,0,0,0,0,0,0,0,0,0,0,0,0,0,0
2833,Uttaranchal,2011,Others,0,0,0,0,0,0,0,0,0,0,0,0,0,0,0
2834,Uttaranchal,2011,Total,1486,67,1553,1640,68,1708,0,0,0,0,0,0,3126,135,3261
2835,Uttaranchal,2012,Central Jail,66,0,66,0,0,0,0,0,0,0,0,0,66,0,66
2836,Uttaranchal,2012,District Jail,1344,67,1411,1015,52,1067,0,0,0,0,0,0,2359,119,2478
2837,Uttaranchal,2012,Sub_Jail,53,1,54,766,29,795,0,0,0,0,0,0,819,30,849
2838,Uttaranchal,2012,Women Jail,0,0,0,0,0,0,0,0,0,0,0,0,0,0,0
2839,Uttaranchal,2012,Borstal School,0,0,0,0,0,0,0,0,0,0,0,0,0,0,0
2840,Uttaranchal,2012,Open Jail,142,0,142,0,0,0,0,0,0,0,0,0,142,0,142
2841,Uttaranchal,2012,Special Jail,0,0,0,0,0,0,0,0,0,0,0,0,0,0,0
2842,Uttaranchal,2012,Others,0,0,0,0,0,0,0,0,0,0,0,0,0,0,0
2843,Uttaranchal,2012,Total,1605,68,1673,1781,81,1862,0,0,0,0,0,0,3386,149,3535
2844,West Bengal,2001,Central Jail,1973,57,2030,4019,148,4167,1,0,1,19,0,19,6012,205,6217
2845,West Bengal,2001,District Jail,272,12,284,2181,115,2296,20,1,21,0,0,0,2473,128,2601
2846,West Bengal,2001,Sub_Jail,92,21,113,2631,119,2750,0,0,0,0,0,0,2723,140,2863
2847,West Bengal,2001,Women Jail,0,16,16,0,5,5,0,0,0,0,0,0,0,21,21
2848,West Bengal,2001,Borstal School,0,0,0,0,0,0,0,0,0,0,0,0,0,0,0
2849,West Bengal,2001,Open Jail,35,0,35,0,0,0,0,0,0,0,0,0,35,0,35
2850,West Bengal,2001,Special Jail,29,0,29,462,42,504,0,0,0,77,0,77,568,42,610
2851,West Bengal,2001,Others,0,0,0,0,0,0,0,0,0,0,0,0,0,0,0
2852,West Bengal,2001,Total,2401,106,2507,9293,429,9722,21,1,22,96,0,96,11811,536,12347
2853,West Bengal,2002,Central Jail,2087,80,2167,7801,278,8079,1,0,1,20,0,20,9909,358,10267
2854,West Bengal,2002,District Jail,276,30,306,3546,208,3754,0,0,0,0,0,0,3822,238,4060
2855,West Bengal,2002,Sub_Jail,61,12,73,3260,198,3458,0,0,0,0,1,1,3321,211,3532
2856,West Bengal,2002,Women Jail,0,17,17,0,7,7,0,0,0,0,0,0,0,24,24
2857,West Bengal,2002,Borstal School,0,0,0,0,0,0,0,0,0,0,0,0,0,0,0
2858,West Bengal,2002,Open Jail,25,0,25,0,0,0,0,0,0,0,0,0,25,0,25
2859,West Bengal,2002,Special Jail,23,0,23,707,31,738,0,0,0,74,0,74,804,31,835
2860,West Bengal,2002,Others,0,0,0,0,0,0,0,0,0,0,0,0,0,0,0
2861,West Bengal,2002,Total,2472,139,2611,15314,722,16036,1,0,1,94,1,95,17881,862,18743
2862,West Bengal,2003,Central Jail,2623,181,2804,5789,177,5966,3,0,3,5,0,5,8420,358,8778
2863,West Bengal,2003,District Jail,423,69,492,2845,233,3078,0,0,0,0,0,0,3268,302,3570
2864,West Bengal,2003,Sub_Jail,76,1,77,2947,170,3117,0,0,0,0,0,0,3023,171,3194
2865,West Bengal,2003,Women Jail,0,17,17,0,21,21,0,0,0,0,0,0,0,38,38
2866,West Bengal,2003,Borstal School,0,0,0,0,0,0,0,0,0,0,0,0,0,0,0
2867,West Bengal,2003,Open Jail,20,0,20,0,0,0,0,0,0,0,0,0,20,0,20
2868,West Bengal,2003,Special Jail,40,0,40,553,22,575,0,0,0,74,0,74,667,22,689
2869,West Bengal,2003,Others,0,0,0,0,0,0,0,0,0,0,0,0,0,0,0
2870,West Bengal,2003,Total,3182,268,3450,12134,623,12757,3,0,3,79,0,79,15398,891,16289
2871,West Bengal,2004,Central Jail,2881,133,3014,5829,217,6046,0,0,0,5,0,5,8715,350,9065
2872,West Bengal,2004,District Jail,329,11,340,2735,166,2901,0,0,0,1,3,4,3065,180,3245
2873,West Bengal,2004,Sub_Jail,68,4,72,2772,252,3024,0,0,0,0,0,0,2840,256,3096
2874,West Bengal,2004,Women Jail,0,34,34,0,9,9,0,0,0,0,0,0,0,43,43
2875,West Bengal,2004,Borstal School,0,0,0,0,0,0,0,0,0,0,0,0,0,0,0
2876,West Bengal,2004,Open Jail,23,0,23,0,0,0,0,0,0,0,0,0,23,0,23
2877,West Bengal,2004,Special Jail,33,4,37,766,44,810,0,0,0,0,0,0,799,48,847
2878,West Bengal,2004,Others,0,0,0,0,0,0,0,0,0,0,0,0,0,0,0
2879,West Bengal,2004,Total,3334,186,3520,12102,688,12790,0,0,0,6,3,9,15442,877,16319
2880,West Bengal,2005,Central Jail,3211,146,3357,6558,518,7076,3,0,3,37,0,37,9809,664,10473
2881,West Bengal,2005,District Jail,284,10,294,3169,215,3384,0,0,0,48,13,61,3501,238,3739
2882,West Bengal,2005,Sub_Jail,53,17,70,2534,232,2766,45,2,47,64,13,77,2696,264,2960
2883,West Bengal,2005,Women Jail,0,43,43,0,9,9,0,0,0,0,0,0,0,52,52
2884,West Bengal,2005,Borstal School,0,0,0,0,0,0,0,0,0,0,0,0,0,0,0
2885,West Bengal,2005,Open Jail,28,0,28,0,0,0,0,0,0,0,0,0,28,0,28
2886,West Bengal,2005,Special Jail,52,4,56,744,38,782,8,0,8,60,0,60,864,42,906
2887,West Bengal,2005,Others,0,0,0,0,0,0,0,0,0,0,0,0,0,0,0
2888,West Bengal,2005,Total,3628,220,3848,13005,1012,14017,56,2,58,209,26,235,16898,1260,18158
2889,West Bengal,2006,Central Jail,3266,173,3439,6465,321,6786,0,0,0,58,4,62,9789,498,10287
2890,West Bengal,2006,District Jail,224,7,231,3311,280,3591,0,0,0,87,6,93,3622,293,3915
2891,West Bengal,2006,Sub_Jail,53,3,56,2808,168,2976,0,0,0,60,10,70,2921,181,3102
2892,West Bengal,2006,Women Jail,0,44,44,0,8,8,0,0,0,0,0,0,0,52,52
2893,West Bengal,2006,Borstal School,0,0,0,0,0,0,0,0,0,0,0,0,0,0,0
2894,West Bengal,2006,Open Jail,68,0,68,0,0,0,0,0,0,0,0,0,68,0,68
2895,West Bengal,2006,Special Jail,36,2,38,705,26,731,0,0,0,0,0,0,741,28,769
2896,West Bengal,2006,Others,0,0,0,0,0,0,0,0,0,0,0,0,0,0,0
2897,West Bengal,2006,Total,3647,229,3876,13289,803,14092,0,0,0,205,20,225,17141,1052,18193
2898,West Bengal,2007,Central Jail,3648,151,3799,5733,502,6235,0,0,0,149,19,168,9530,672,10202
2899,West Bengal,2007,District Jail,292,13,305,3702,249,3951,0,0,0,7,2,9,4001,264,4265
2900,West Bengal,2007,Sub_Jail,67,1,68,2791,195,2986,0,0,0,83,32,115,2941,228,3169
2901,West Bengal,2007,Women Jail,0,40,40,0,11,11,0,0,0,0,0,0,0,51,51
2902,West Bengal,2007,Borstal School,0,0,0,0,0,0,0,0,0,0,0,0,0,0,0
2903,West Bengal,2007,Open Jail,86,0,86,0,0,0,0,0,0,0,0,0,86,0,86
2904,West Bengal,2007,Special Jail,41,6,47,733,45,778,0,0,0,0,0,0,774,51,825
2905,West Bengal,2007,Others,0,0,0,0,0,0,0,0,0,0,0,0,0,0,0
2906,West Bengal,2007,Total,4134,211,4345,12959,1002,13961,0,0,0,239,53,292,17332,1266,18598
2907,West Bengal,2008,Central Jail,4909,164,5073,5386,266,5652,0,0,0,29,0,29,10324,430,10754
2908,West Bengal,2008,District Jail,445,44,489,3542,291,3833,0,0,0,0,4,4,3987,339,4326
2909,West Bengal,2008,Sub_Jail,73,2,75,3352,217,3569,0,0,0,82,22,104,3507,241,3748
2910,West Bengal,2008,Women Jail,0,114,114,0,225,225,0,0,0,0,0,0,0,339,339
2911,West Bengal,2008,Borstal School,0,0,0,0,0,0,0,0,0,0,0,0,0,0,0
2912,West Bengal,2008,Open Jail,103,0,103,0,0,0,0,0,0,0,0,0,103,0,103
2913,West Bengal,2008,Special Jail,107,20,127,779,53,832,0,0,0,0,1,1,886,74,960
2914,West Bengal,2008,Others,0,0,0,0,0,0,0,0,0,0,0,0,0,0,0
2915,West Bengal,2008,Total,5637,344,5981,13059,1052,14111,0,0,0,111,27,138,18807,1423,20230
2916,West Bengal,2009,Central Jail,4390,183,4573,5449,177,5626,1,2,3,108,14,122,9948,376,10324
2917,West Bengal,2009,District Jail,798,71,869,2810,220,3030,0,0,0,4,1,5,3612,292,3904
2918,West Bengal,2009,Sub_Jail,66,2,68,1891,96,1987,0,0,0,70,2,72,2027,100,2127
2919,West Bengal,2009,Women Jail,0,112,112,0,154,154,0,0,0,0,0,0,0,266,266
2920,West Bengal,2009,Borstal School,0,0,0,0,0,0,0,0,0,0,0,0,0,0,0
2921,West Bengal,2009,Open Jail,98,0,98,0,0,0,0,0,0,0,0,0,98,0,98
2922,West Bengal,2009,Special Jail,162,37,199,624,44,668,0,0,0,0,0,0,786,81,867
2923,West Bengal,2009,Others,0,0,0,0,0,0,0,0,0,0,0,0,0,0,0
2924,West Bengal,2009,Total,5514,405,5919,10774,691,11465,1,2,3,182,17,199,16471,1115,17586
2925,West Bengal,2010,Central Jail,4073,194,4267,4949,149,5098,1,0,1,278,29,307,9301,372,9673
2926,West Bengal,2010,District Jail,1075,60,1135,2950,204,3154,0,0,0,18,2,20,4043,266,4309
2927,West Bengal,2010,Sub_Jail,37,2,39,3077,183,3260,0,0,0,33,0,33,3147,185,3332
2928,West Bengal,2010,Women Jail,0,115,115,0,154,154,0,0,0,0,0,0,0,269,269
2929,West Bengal,2010,Borstal School,0,0,0,0,0,0,0,0,0,0,0,0,0,0,0
2930,West Bengal,2010,Open Jail,96,0,96,0,0,0,0,0,0,0,0,0,96,0,96
2931,West Bengal,2010,Special Jail,116,10,126,649,46,695,0,0,0,14,5,19,779,61,840
2932,West Bengal,2010,Others,0,0,0,0,0,0,0,0,0,0,0,0,0,0,0
2933,West Bengal,2010,Total,5397,381,5778,11625,736,12361,1,0,1,343,36,379,17366,1153,18519
2934,West Bengal,2011,Central Jail,4132,152,4284,5003,156,5159,5,0,5,236,27,263,9376,335,9711
2935,West Bengal,2011,District Jail,905,48,953,3718,221,3939,0,0,0,7,4,11,4630,273,4903
2936,West Bengal,2011,Sub_Jail,48,0,48,3379,172,3551,0,0,0,0,0,0,3427,172,3599
2937,West Bengal,2011,Women Jail,0,152,152,0,178,178,0,0,0,0,0,0,0,330,330
2938,West Bengal,2011,Borstal School,0,0,0,0,0,0,0,0,0,0,0,0,0,0,0
2939,West Bengal,2011,Open Jail,99,0,99,0,0,0,0,0,0,0,0,0,99,0,99
2940,West Bengal,2011,Special Jail,114,10,124,704,36,740,0,0,0,1,1,2,819,47,866
2941,West Bengal,2011,Others,0,0,0,0,0,0,0,0,0,0,0,0,0,0,0
2942,West Bengal,2011,Total,5298,362,5660,12804,763,13567,5,0,5,244,32,276,18351,1157,19508
2943,West Bengal,2012,Central Jail,4608,185,4793,5622,249,5871,1,0,1,240,39,279,10471,473,10944
2944,West Bengal,2012,District Jail,916,60,976,3122,202,3324,2,0,2,0,1,1,4040,263,4303
2945,West Bengal,2012,Sub_Jail,99,2,101,3585,169,3754,0,0,0,0,0,0,3684,171,3855
2946,West Bengal,2012,Women Jail,0,147,147,0,206,206,0,0,0,0,0,0,0,353,353
2947,West Bengal,2012,Borstal School,0,0,0,0,0,0,0,0,0,0,0,0,0,0,0
2948,West Bengal,2012,Open Jail,76,0,76,0,0,0,0,0,0,0,0,0,76,0,76
2949,West Bengal,2012,Special Jail,68,10,78,777,45,822,0,0,0,0,0,0,845,55,900
2950,West Bengal,2012,Others,0,0,0,0,0,0,0,0,0,0,0,0,0,0,0
2951,West Bengal,2012,Total,5767,404,6171,13106,871,13977,3,0,3,240,40,280,19116,1315,20431
2952,A & N Islands,2001,Central Jail,0,0,0,0,0,0,0,0,0,0,0,0,0,0,0
2953,A & N Islands,2001,District Jail,214,3,217,159,0,159,0,0,0,0,0,0,373,3,376
2954,A & N Islands,2001,Sub_Jail,0,0,0,0,0,0,0,0,0,0,0,0,0,0,0
2955,A & N Islands,2001,Women Jail,0,0,0,0,0,0,0,0,0,0,0,0,0,0,0
2956,A & N Islands,2001,Borstal School,0,0,0,0,0,0,0,0,0,0,0,0,0,0,0
2957,A & N Islands,2001,Open Jail,0,0,0,0,0,0,0,0,0,0,0,0,0,0,0
2958,A & N Islands,2001,Special Jail,0,0,0,0,0,0,0,0,0,0,0,0,0,0,0
2959,A & N Islands,2001,Others,0,0,0,6,1,7,0,0,0,0,0,0,6,1,7
2960,A & N Islands,2001,Total,214,3,217,165,1,166,0,0,0,0,0,0,379,4,383
2961,A & N Islands,2002,Central Jail,0,0,0,0,0,0,0,0,0,0,0,0,0,0,0
2962,A & N Islands,2002,District Jail,133,4,137,183,2,185,0,0,0,0,0,0,316,6,322
2963,A & N Islands,2002,Sub_Jail,0,0,0,0,0,0,0,0,0,0,0,0,0,0,0
2964,A & N Islands,2002,Women Jail,0,0,0,0,0,0,0,0,0,0,0,0,0,0,0
2965,A & N Islands,2002,Borstal School,0,0,0,0,0,0,0,0,0,0,0,0,0,0,0
2966,A & N Islands,2002,Open Jail,0,0,0,0,0,0,0,0,0,0,0,0,0,0,0
2967,A & N Islands,2002,Special Jail,0,0,0,0,0,0,0,0,0,0,0,0,0,0,0
2968,A & N Islands,2002,Others,0,0,0,7,2,9,0,0,0,0,0,0,7,2,9
2969,A & N Islands,2002,Total,133,4,137,190,4,194,0,0,0,0,0,0,323,8,331
2970,A & N Islands,2003,Central Jail,0,0,0,0,0,0,0,0,0,0,0,0,0,0,0
2971,A & N Islands,2003,District Jail,90,2,92,189,1,190,0,0,0,0,0,0,279,3,282
2972,A & N Islands,2003,Sub_Jail,0,0,0,0,0,0,0,0,0,0,0,0,0,0,0
2973,A & N Islands,2003,Women Jail,0,0,0,0,0,0,0,0,0,0,0,0,0,0,0
2974,A & N Islands,2003,Borstal School,0,0,0,0,0,0,0,0,0,0,0,0,0,0,0
2975,A & N Islands,2003,Open Jail,0,0,0,0,0,0,0,0,0,0,0,0,0,0,0
2976,A & N Islands,2003,Special Jail,0,0,0,0,0,0,0,0,0,0,0,0,0,0,0
2977,A & N Islands,2003,Others,0,0,0,14,0,14,0,0,0,0,0,0,14,0,14
2978,A & N Islands,2003,Total,90,2,92,203,1,204,0,0,0,0,0,0,293,3,296
2979,A & N Islands,2004,Central Jail,0,0,0,0,0,0,0,0,0,0,0,0,0,0,0
2980,A & N Islands,2004,District Jail,54,2,56,156,1,157,0,0,0,0,0,0,210,3,213
2981,A & N Islands,2004,Sub_Jail,0,0,0,8,0,8,0,0,0,0,0,0,8,0,8
2982,A & N Islands,2004,Women Jail,0,0,0,0,0,0,0,0,0,0,0,0,0,0,0
2983,A & N Islands,2004,Borstal School,0,0,0,0,0,0,0,0,0,0,0,0,0,0,0
2984,A & N Islands,2004,Open Jail,0,0,0,0,0,0,0,0,0,0,0,0,0,0,0
2985,A & N Islands,2004,Special Jail,0,0,0,0,0,0,0,0,0,0,0,0,0,0,0
2986,A & N Islands,2004,Others,0,0,0,0,0,0,0,0,0,0,0,0,0,0,0
2987,A & N Islands,2004,Total,54,2,56,164,1,165,0,0,0,0,0,0,218,3,221
2988,A & N Islands,2005,Central Jail,0,0,0,0,0,0,0,0,0,0,0,0,0,0,0
2989,A & N Islands,2005,District Jail,64,1,65,151,3,154,0,0,0,0,0,0,215,4,219
2990,A & N Islands,2005,Sub_Jail,1,0,1,4,0,4,0,0,0,0,0,0,5,0,5
2991,A & N Islands,2005,Women Jail,0,0,0,0,0,0,0,0,0,0,0,0,0,0,0
2992,A & N Islands,2005,Borstal School,0,0,0,0,0,0,0,0,0,0,0,0,0,0,0
2993,A & N Islands,2005,Open Jail,0,0,0,0,0,0,0,0,0,0,0,0,0,0,0
2994,A & N Islands,2005,Special Jail,0,0,0,0,0,0,0,0,0,0,0,0,0,0,0
2995,A & N Islands,2005,Others,0,0,0,0,0,0,0,0,0,0,0,0,0,0,0
2996,A & N Islands,2005,Total,65,1,66,155,3,158,0,0,0,0,0,0,220,4,224
2997,A & N Islands,2006,Central Jail,0,0,0,0,0,0,0,0,0,0,0,0,0,0,0
2998,A & N Islands,2006,District Jail,80,1,81,258,1,259,0,0,0,0,0,0,338,2,340
2999,A & N Islands,2006,Sub_Jail,0,0,0,6,0,6,0,0,0,0,0,0,6,0,6
3000,A & N Islands,2006,Women Jail,0,0,0,0,0,0,0,0,0,0,0,0,0,0,0
3001,A & N Islands,2006,Borstal School,0,0,0,0,0,0,0,0,0,0,0,0,0,0,0
3002,A & N Islands,2006,Open Jail,0,0,0,0,0,0,0,0,0,0,0,0,0,0,0
3003,A & N Islands,2006,Special Jail,0,0,0,0,0,0,0,0,0,0,0,0,0,0,0
3004,A & N Islands,2006,Others,0,0,0,0,0,0,0,0,0,0,0,0,0,0,0
3005,A & N Islands,2006,Total,80,1,81,264,1,265,0,0,0,0,0,0,344,2,346
3006,A & N Islands,2007,Central Jail,0,0,0,0,0,0,0,0,0,0,0,0,0,0,0
3007,A & N Islands,2007,District Jail,86,1,87,314,0,314,0,0,0,0,0,0,400,1,401
3008,A & N Islands,2007,Sub_Jail,1,0,1,10,1,11,0,0,0,0,0,0,11,1,12
3009,A & N Islands,2007,Women Jail,0,0,0,0,0,0,0,0,0,0,0,0,0,0,0
3010,A & N Islands,2007,Borstal School,0,0,0,0,0,0,0,0,0,0,0,0,0,0,0
3011,A & N Islands,2007,Open Jail,0,0,0,0,0,0,0,0,0,0,0,0,0,0,0
3012,A & N Islands,2007,Special Jail,0,0,0,0,0,0,0,0,0,0,0,0,0,0,0
3013,A & N Islands,2007,Others,0,0,0,0,0,0,0,0,0,0,0,0,0,0,0
3014,A & N Islands,2007,Total,87,1,88,324,1,325,0,0,0,0,0,0,411,2,413
3015,A & N Islands,2008,Central Jail,0,0,0,0,0,0,0,0,0,0,0,0,0,0,0
3016,A & N Islands,2008,District Jail,67,0,67,142,0,142,0,0,0,0,0,0,209,0,209
3017,A & N Islands,2008,Sub_Jail,1,0,1,11,0,11,0,0,0,0,0,0,12,0,12
3018,A & N Islands,2008,Women Jail,0,0,0,0,0,0,0,0,0,0,0,0,0,0,0
3019,A & N Islands,2008,Borstal School,0,0,0,0,0,0,0,0,0,0,0,0,0,0,0
3020,A & N Islands,2008,Open Jail,0,0,0,0,0,0,0,0,0,0,0,0,0,0,0
3021,A & N Islands,2008,Special Jail,0,0,0,0,0,0,0,0,0,0,0,0,0,0,0
3022,A & N Islands,2008,Others,0,0,0,0,0,0,0,0,0,0,0,0,0,0,0
3023,A & N Islands,2008,Total,68,0,68,153,0,153,0,0,0,0,0,0,221,0,221
3024,A & N Islands,2009,Central Jail,0,0,0,0,0,0,0,0,0,0,0,0,0,0,0
3025,A & N Islands,2009,District Jail,46,0,46,165,0,165,0,0,0,0,0,0,211,0,211
3026,A & N Islands,2009,Sub_Jail,2,0,2,15,0,15,0,0,0,0,0,0,17,0,17
3027,A & N Islands,2009,Women Jail,0,0,0,0,0,0,0,0,0,0,0,0,0,0,0
3028,A & N Islands,2009,Borstal School,0,0,0,0,0,0,0,0,0,0,0,0,0,0,0
3029,A & N Islands,2009,Open Jail,0,0,0,0,0,0,0,0,0,0,0,0,0,0,0
3030,A & N Islands,2009,Special Jail,0,0,0,0,0,0,0,0,0,0,0,0,0,0,0
3031,A & N Islands,2009,Others,0,0,0,0,0,0,0,0,0,0,0,0,0,0,0
3032,A & N Islands,2009,Total,48,0,48,180,0,180,0,0,0,0,0,0,228,0,228
3033,A & N Islands,2010,Central Jail,0,0,0,0,0,0,0,0,0,0,0,0,0,0,0
3034,A & N Islands,2010,District Jail,120,0,120,542,2,544,0,0,0,0,0,0,662,2,664
3035,A & N Islands,2010,Sub_Jail,9,0,9,15,0,15,0,0,0,0,0,0,24,0,24
3036,A & N Islands,2010,Women Jail,0,0,0,0,0,0,0,0,0,0,0,0,0,0,0
3037,A & N Islands,2010,Borstal School,0,0,0,0,0,0,0,0,0,0,0,0,0,0,0
3038,A & N Islands,2010,Open Jail,0,0,0,0,0,0,0,0,0,0,0,0,0,0,0
3039,A & N Islands,2010,Special Jail,0,0,0,0,0,0,0,0,0,0,0,0,0,0,0
3040,A & N Islands,2010,Others,0,0,0,0,0,0,0,0,0,0,0,0,0,0,0
3041,A & N Islands,2010,Total,129,0,129,557,2,559,0,0,0,0,0,0,686,2,688
3042,A & N Islands,2011,Central Jail,0,0,0,0,0,0,0,0,0,0,0,0,0,0,0
3043,A & N Islands,2011,District Jail,411,0,411,684,6,690,0,0,0,0,0,0,1095,6,1101
3044,A & N Islands,2011,Sub_Jail,4,0,4,13,1,14,0,0,0,0,0,0,17,1,18
3045,A & N Islands,2011,Women Jail,0,0,0,0,0,0,0,0,0,0,0,0,0,0,0
3046,A & N Islands,2011,Borstal School,0,0,0,0,0,0,0,0,0,0,0,0,0,0,0
3047,A & N Islands,2011,Open Jail,0,0,0,0,0,0,0,0,0,0,0,0,0,0,0
3048,A & N Islands,2011,Special Jail,0,0,0,0,0,0,0,0,0,0,0,0,0,0,0
3049,A & N Islands,2011,Others,0,0,0,0,0,0,0,0,0,0,0,0,0,0,0
3050,A & N Islands,2011,Total,415,0,415,697,7,704,0,0,0,0,0,0,1112,7,1119
3051,A & N Islands,2012,Central Jail,0,0,0,0,0,0,0,0,0,0,0,0,0,0,0
3052,A & N Islands,2012,District Jail,654,0,654,340,8,348,0,0,0,0,0,0,994,8,1002
3053,A & N Islands,2012,Sub_Jail,4,0,4,17,1,18,0,0,0,0,0,0,21,1,22
3054,A & N Islands,2012,Women Jail,0,0,0,0,0,0,0,0,0,0,0,0,0,0,0
3055,A & N Islands,2012,Borstal School,0,0,0,0,0,0,0,0,0,0,0,0,0,0,0
3056,A & N Islands,2012,Open Jail,0,0,0,0,0,0,0,0,0,0,0,0,0,0,0
3057,A & N Islands,2012,Special Jail,102,0,102,0,0,0,0,0,0,0,0,0,102,0,102
3058,A & N Islands,2012,Others,0,0,0,0,0,0,0,0,0,0,0,0,0,0,0
3059,A & N Islands,2012,Total,760,0,760,357,9,366,0,0,0,0,0,0,1117,9,1126
3060,Chandigarh,2001,Central Jail,0,0,0,0,0,0,0,0,0,0,0,0,0,0,0
3061,Chandigarh,2001,District Jail,0,0,0,0,0,0,0,0,0,0,0,0,0,0,0
3062,Chandigarh,2001,Sub_Jail,0,0,0,0,0,0,0,0,0,0,0,0,0,0,0
3063,Chandigarh,2001,Women Jail,0,0,0,0,0,0,0,0,0,0,0,0,0,0,0
3064,Chandigarh,2001,Borstal School,0,0,0,0,0,0,0,0,0,0,0,0,0,0,0
3065,Chandigarh,2001,Open Jail,0,0,0,0,0,0,0,0,0,0,0,0,0,0,0
3066,Chandigarh,2001,Special Jail,0,0,0,0,0,0,0,0,0,0,0,0,0,0,0
3067,Chandigarh,2001,Others,96,6,102,306,18,324,0,0,0,0,0,0,402,24,426
3068,Chandigarh,2001,Total,96,6,102,306,18,324,0,0,0,0,0,0,402,24,426
3069,Chandigarh,2002,Central Jail,0,0,0,0,0,0,0,0,0,0,0,0,0,0,0
3070,Chandigarh,2002,District Jail,0,0,0,0,0,0,0,0,0,0,0,0,0,0,0
3071,Chandigarh,2002,Sub_Jail,0,0,0,0,0,0,0,0,0,0,0,0,0,0,0
3072,Chandigarh,2002,Women Jail,0,0,0,0,0,0,0,0,0,0,0,0,0,0,0
3073,Chandigarh,2002,Borstal School,0,0,0,0,0,0,0,0,0,0,0,0,0,0,0
3074,Chandigarh,2002,Open Jail,0,0,0,0,0,0,0,0,0,0,0,0,0,0,0
3075,Chandigarh,2002,Special Jail,0,0,0,0,0,0,0,0,0,0,0,0,0,0,0
3076,Chandigarh,2002,Others,104,7,111,329,16,345,0,0,0,0,0,0,433,23,456
3077,Chandigarh,2002,Total,104,7,111,329,16,345,0,0,0,0,0,0,433,23,456
3078,Chandigarh,2003,Central Jail,0,0,0,0,0,0,0,0,0,0,0,0,0,0,0
3079,Chandigarh,2003,District Jail,0,0,0,0,0,0,0,0,0,0,0,0,0,0,0
3080,Chandigarh,2003,Sub_Jail,0,0,0,0,0,0,0,0,0,0,0,0,0,0,0
3081,Chandigarh,2003,Women Jail,0,0,0,0,0,0,0,0,0,0,0,0,0,0,0
3082,Chandigarh,2003,Borstal School,0,0,0,0,0,0,0,0,0,0,0,0,0,0,0
3083,Chandigarh,2003,Open Jail,0,0,0,0,0,0,0,0,0,0,0,0,0,0,0
3084,Chandigarh,2003,Special Jail,0,0,0,0,0,0,0,0,0,0,0,0,0,0,0
3085,Chandigarh,2003,Others,135,9,144,363,18,381,0,0,0,0,0,0,498,27,525
3086,Chandigarh,2003,Total,135,9,144,363,18,381,0,0,0,0,0,0,498,27,525
3087,Chandigarh,2004,Central Jail,0,0,0,0,0,0,0,0,0,0,0,0,0,0,0
3088,Chandigarh,2004,District Jail,0,0,0,0,0,0,0,0,0,0,0,0,0,0,0
3089,Chandigarh,2004,Sub_Jail,0,0,0,0,0,0,0,0,0,0,0,0,0,0,0
3090,Chandigarh,2004,Women Jail,0,0,0,0,0,0,0,0,0,0,0,0,0,0,0
3091,Chandigarh,2004,Borstal School,0,0,0,0,0,0,0,0,0,0,0,0,0,0,0
3092,Chandigarh,2004,Open Jail,0,0,0,0,0,0,0,0,0,0,0,0,0,0,0
3093,Chandigarh,2004,Special Jail,0,0,0,0,0,0,0,0,0,0,0,0,0,0,0
3094,Chandigarh,2004,Others,113,7,120,405,24,429,0,0,0,0,0,0,518,31,549
3095,Chandigarh,2004,Total,113,7,120,405,24,429,0,0,0,0,0,0,518,31,549
3096,Chandigarh,2005,Central Jail,0,0,0,0,0,0,0,0,0,0,0,0,0,0,0
3097,Chandigarh,2005,District Jail,0,0,0,0,0,0,0,0,0,0,0,0,0,0,0
3098,Chandigarh,2005,Sub_Jail,0,0,0,0,0,0,0,0,0,0,0,0,0,0,0
3099,Chandigarh,2005,Women Jail,0,0,0,0,0,0,0,0,0,0,0,0,0,0,0
3100,Chandigarh,2005,Borstal School,0,0,0,0,0,0,0,0,0,0,0,0,0,0,0
3101,Chandigarh,2005,Open Jail,0,0,0,0,0,0,0,0,0,0,0,0,0,0,0
3102,Chandigarh,2005,Special Jail,0,0,0,0,0,0,0,0,0,0,0,0,0,0,0
3103,Chandigarh,2005,Others,78,6,84,351,20,371,0,0,0,0,0,0,429,26,455
3104,Chandigarh,2005,Total,78,6,84,351,20,371,0,0,0,0,0,0,429,26,455
3105,Chandigarh,2006,Central Jail,0,0,0,0,0,0,0,0,0,0,0,0,0,0,0
3106,Chandigarh,2006,District Jail,0,0,0,0,0,0,0,0,0,0,0,0,0,0,0
3107,Chandigarh,2006,Sub_Jail,0,0,0,0,0,0,0,0,0,0,0,0,0,0,0
3108,Chandigarh,2006,Women Jail,0,0,0,0,0,0,0,0,0,0,0,0,0,0,0
3109,Chandigarh,2006,Borstal School,0,0,0,0,0,0,0,0,0,0,0,0,0,0,0
3110,Chandigarh,2006,Open Jail,0,0,0,0,0,0,0,0,0,0,0,0,0,0,0
3111,Chandigarh,2006,Special Jail,0,0,0,0,0,0,0,0,0,0,0,0,0,0,0
3112,Chandigarh,2006,Others,100,7,107,312,19,331,0,0,0,0,0,0,412,26,438
3113,Chandigarh,2006,Total,100,7,107,312,19,331,0,0,0,0,0,0,412,26,438
3114,Chandigarh,2007,Central Jail,141,5,146,342,13,355,0,0,0,0,0,0,483,18,501
3115,Chandigarh,2007,District Jail,0,0,0,0,0,0,0,0,0,0,0,0,0,0,0
3116,Chandigarh,2007,Sub_Jail,0,0,0,0,0,0,0,0,0,0,0,0,0,0,0
3117,Chandigarh,2007,Women Jail,0,0,0,0,0,0,0,0,0,0,0,0,0,0,0
3118,Chandigarh,2007,Borstal School,0,0,0,0,0,0,0,0,0,0,0,0,0,0,0
3119,Chandigarh,2007,Open Jail,0,0,0,0,0,0,0,0,0,0,0,0,0,0,0
3120,Chandigarh,2007,Special Jail,0,0,0,0,0,0,0,0,0,0,0,0,0,0,0
3121,Chandigarh,2007,Others,0,0,0,0,0,0,0,0,0,0,0,0,0,0,0
3122,Chandigarh,2007,Total,141,5,146,342,13,355,0,0,0,0,0,0,483,18,501
3123,Chandigarh,2008,Central Jail,183,5,188,326,12,338,0,0,0,0,0,0,509,17,526
3124,Chandigarh,2008,District Jail,0,0,0,0,0,0,0,0,0,0,0,0,0,0,0
3125,Chandigarh,2008,Sub_Jail,0,0,0,0,0,0,0,0,0,0,0,0,0,0,0
3126,Chandigarh,2008,Women Jail,0,0,0,0,0,0,0,0,0,0,0,0,0,0,0
3127,Chandigarh,2008,Borstal School,0,0,0,0,0,0,0,0,0,0,0,0,0,0,0
3128,Chandigarh,2008,Open Jail,0,0,0,0,0,0,0,0,0,0,0,0,0,0,0
3129,Chandigarh,2008,Special Jail,0,0,0,0,0,0,0,0,0,0,0,0,0,0,0
3130,Chandigarh,2008,Others,0,0,0,0,0,0,0,0,0,0,0,0,0,0,0
3131,Chandigarh,2008,Total,183,5,188,326,12,338,0,0,0,0,0,0,509,17,526
3132,Chandigarh,2009,Central Jail,235,9,244,379,20,399,0,0,0,0,0,0,614,29,643
3133,Chandigarh,2009,District Jail,0,0,0,0,0,0,0,0,0,0,0,0,0,0,0
3134,Chandigarh,2009,Sub_Jail,0,0,0,0,0,0,0,0,0,0,0,0,0,0,0
3135,Chandigarh,2009,Women Jail,0,0,0,0,0,0,0,0,0,0,0,0,0,0,0
3136,Chandigarh,2009,Borstal School,0,0,0,0,0,0,0,0,0,0,0,0,0,0,0
3137,Chandigarh,2009,Open Jail,0,0,0,0,0,0,0,0,0,0,0,0,0,0,0
3138,Chandigarh,2009,Special Jail,0,0,0,0,0,0,0,0,0,0,0,0,0,0,0
3139,Chandigarh,2009,Others,0,0,0,0,0,0,0,0,0,0,0,0,0,0,0
3140,Chandigarh,2009,Total,235,9,244,379,20,399,0,0,0,0,0,0,614,29,643
3141,Chandigarh,2010,Central Jail,211,10,221,400,19,419,0,0,0,0,0,0,611,29,640
3142,Chandigarh,2010,District Jail,0,0,0,0,0,0,0,0,0,0,0,0,0,0,0
3143,Chandigarh,2010,Sub_Jail,0,0,0,0,0,0,0,0,0,0,0,0,0,0,0
3144,Chandigarh,2010,Women Jail,0,0,0,0,0,0,0,0,0,0,0,0,0,0,0
3145,Chandigarh,2010,Borstal School,0,0,0,0,0,0,0,0,0,0,0,0,0,0,0
3146,Chandigarh,2010,Open Jail,0,0,0,0,0,0,0,0,0,0,0,0,0,0,0
3147,Chandigarh,2010,Special Jail,0,0,0,0,0,0,0,0,0,0,0,0,0,0,0
3148,Chandigarh,2010,Others,0,0,0,0,0,0,0,0,0,0,0,0,0,0,0
3149,Chandigarh,2010,Total,211,10,221,400,19,419,0,0,0,0,0,0,611,29,640
3150,Chandigarh,2011,Central Jail,236,6,242,368,16,384,0,0,0,0,0,0,604,22,626
3151,Chandigarh,2011,District Jail,0,0,0,0,0,0,0,0,0,0,0,0,0,0,0
3152,Chandigarh,2011,Sub_Jail,0,0,0,0,0,0,0,0,0,0,0,0,0,0,0
3153,Chandigarh,2011,Women Jail,0,0,0,0,0,0,0,0,0,0,0,0,0,0,0
3154,Chandigarh,2011,Borstal School,0,0,0,0,0,0,0,0,0,0,0,0,0,0,0
3155,Chandigarh,2011,Open Jail,0,0,0,0,0,0,0,0,0,0,0,0,0,0,0
3156,Chandigarh,2011,Special Jail,0,0,0,0,0,0,0,0,0,0,0,0,0,0,0
3157,Chandigarh,2011,Others,0,0,0,0,0,0,0,0,0,0,0,0,0,0,0
3158,Chandigarh,2011,Total,236,6,242,368,16,384,0,0,0,0,0,0,604,22,626
3159,Chandigarh,2012,Central Jail,246,15,261,447,26,473,0,0,0,0,0,0,693,41,734
3160,Chandigarh,2012,District Jail,0,0,0,0,0,0,0,0,0,0,0,0,0,0,0
3161,Chandigarh,2012,Sub_Jail,0,0,0,0,0,0,0,0,0,0,0,0,0,0,0
3162,Chandigarh,2012,Women Jail,0,0,0,0,0,0,0,0,0,0,0,0,0,0,0
3163,Chandigarh,2012,Borstal School,0,0,0,0,0,0,0,0,0,0,0,0,0,0,0
3164,Chandigarh,2012,Open Jail,0,0,0,0,0,0,0,0,0,0,0,0,0,0,0
3165,Chandigarh,2012,Special Jail,0,0,0,0,0,0,0,0,0,0,0,0,0,0,0
3166,Chandigarh,2012,Others,0,0,0,0,0,0,0,0,0,0,0,0,0,0,0
3167,Chandigarh,2012,Total,246,15,261,447,26,473,0,0,0,0,0,0,693,41,734
3168,D & N Haveli,2001,Central Jail,0,0,0,0,0,0,0,0,0,0,0,0,0,0,0
3169,D & N Haveli,2001,District Jail,0,0,0,0,0,0,0,0,0,0,0,0,0,0,0
3170,D & N Haveli,2001,Sub_Jail,8,0,8,153,5,158,0,0,0,0,0,0,161,5,166
3171,D & N Haveli,2001,Women Jail,0,0,0,0,0,0,0,0,0,0,0,0,0,0,0
3172,D & N Haveli,2001,Borstal School,0,0,0,0,0,0,0,0,0,0,0,0,0,0,0
3173,D & N Haveli,2001,Open Jail,0,0,0,0,0,0,0,0,0,0,0,0,0,0,0
3174,D & N Haveli,2001,Special Jail,0,0,0,0,0,0,0,0,0,0,0,0,0,0,0
3175,D & N Haveli,2001,Others,0,0,0,0,0,0,0,0,0,0,0,0,0,0,0
3176,D & N Haveli,2001,Total,8,0,8,153,5,158,0,0,0,0,0,0,161,5,166
3177,D & N Haveli,2002,Central Jail,0,0,0,0,0,0,0,0,0,0,0,0,0,0,0
3178,D & N Haveli,2002,District Jail,0,0,0,0,0,0,0,0,0,0,0,0,0,0,0
3179,D & N Haveli,2002,Sub_Jail,4,1,5,154,1,155,0,0,0,0,0,0,158,2,160
3180,D & N Haveli,2002,Women Jail,0,0,0,0,0,0,0,0,0,0,0,0,0,0,0
3181,D & N Haveli,2002,Borstal School,0,0,0,0,0,0,0,0,0,0,0,0,0,0,0
3182,D & N Haveli,2002,Open Jail,0,0,0,0,0,0,0,0,0,0,0,0,0,0,0
3183,D & N Haveli,2002,Special Jail,0,0,0,0,0,0,0,0,0,0,0,0,0,0,0
3184,D & N Haveli,2002,Others,0,0,0,0,0,0,0,0,0,0,0,0,0,0,0
3185,D & N Haveli,2002,Total,4,1,5,154,1,155,0,0,0,0,0,0,158,2,160
3186,D & N Haveli,2003,Central Jail,0,0,0,0,0,0,0,0,0,0,0,0,0,0,0
3187,D & N Haveli,2003,District Jail,0,0,0,0,0,0,0,0,0,0,0,0,0,0,0
3188,D & N Haveli,2003,Sub_Jail,0,0,0,172,0,172,0,0,0,0,0,0,172,0,172
3189,D & N Haveli,2003,Women Jail,0,0,0,0,0,0,0,0,0,0,0,0,0,0,0
3190,D & N Haveli,2003,Borstal School,0,0,0,0,0,0,0,0,0,0,0,0,0,0,0
3191,D & N Haveli,2003,Open Jail,0,0,0,0,0,0,0,0,0,0,0,0,0,0,0
3192,D & N Haveli,2003,Special Jail,0,0,0,0,0,0,0,0,0,0,0,0,0,0,0
3193,D & N Haveli,2003,Others,0,0,0,0,0,0,0,0,0,0,0,0,0,0,0
3194,D & N Haveli,2003,Total,0,0,0,172,0,172,0,0,0,0,0,0,172,0,172
3195,D & N Haveli,2004,Central Jail,0,0,0,0,0,0,0,0,0,0,0,0,0,0,0
3196,D & N Haveli,2004,District Jail,0,0,0,0,0,0,0,0,0,0,0,0,0,0,0
3197,D & N Haveli,2004,Sub_Jail,0,0,0,33,0,33,0,0,0,0,0,0,33,0,33
3198,D & N Haveli,2004,Women Jail,0,0,0,0,0,0,0,0,0,0,0,0,0,0,0
3199,D & N Haveli,2004,Borstal School,0,0,0,0,0,0,0,0,0,0,0,0,0,0,0
3200,D & N Haveli,2004,Open Jail,0,0,0,0,0,0,0,0,0,0,0,0,0,0,0
3201,D & N Haveli,2004,Special Jail,0,0,0,0,0,0,0,0,0,0,0,0,0,0,0
3202,D & N Haveli,2004,Others,0,0,0,0,0,0,0,0,0,0,0,0,0,0,0
3203,D & N Haveli,2004,Total,0,0,0,33,0,33,0,0,0,0,0,0,33,0,33
3204,D & N Haveli,2005,Central Jail,0,0,0,0,0,0,0,0,0,0,0,0,0,0,0
3205,D & N Haveli,2005,District Jail,0,0,0,0,0,0,0,0,0,0,0,0,0,0,0
3206,D & N Haveli,2005,Sub_Jail,0,0,0,29,0,29,0,0,0,0,0,0,29,0,29
3207,D & N Haveli,2005,Women Jail,0,0,0,0,0,0,0,0,0,0,0,0,0,0,0
3208,D & N Haveli,2005,Borstal School,0,0,0,0,0,0,0,0,0,0,0,0,0,0,0
3209,D & N Haveli,2005,Open Jail,0,0,0,0,0,0,0,0,0,0,0,0,0,0,0
3210,D & N Haveli,2005,Special Jail,0,0,0,0,0,0,0,0,0,0,0,0,0,0,0
3211,D & N Haveli,2005,Others,0,0,0,0,0,0,0,0,0,0,0,0,0,0,0
3212,D & N Haveli,2005,Total,0,0,0,29,0,29,0,0,0,0,0,0,29,0,29
3213,D & N Haveli,2006,Central Jail,0,0,0,0,0,0,0,0,0,0,0,0,0,0,0
3214,D & N Haveli,2006,District Jail,0,0,0,0,0,0,0,0,0,0,0,0,0,0,0
3215,D & N Haveli,2006,Sub_Jail,0,0,0,33,0,33,0,0,0,0,0,0,33,0,33
3216,D & N Haveli,2006,Women Jail,0,0,0,0,0,0,0,0,0,0,0,0,0,0,0
3217,D & N Haveli,2006,Borstal School,0,0,0,0,0,0,0,0,0,0,0,0,0,0,0
3218,D & N Haveli,2006,Open Jail,0,0,0,0,0,0,0,0,0,0,0,0,0,0,0
3219,D & N Haveli,2006,Special Jail,0,0,0,0,0,0,0,0,0,0,0,0,0,0,0
3220,D & N Haveli,2006,Others,0,0,0,0,0,0,0,0,0,0,0,0,0,0,0
3221,D & N Haveli,2006,Total,0,0,0,33,0,33,0,0,0,0,0,0,33,0,33
3222,D & N Haveli,2007,Central Jail,0,0,0,0,0,0,0,0,0,0,0,0,0,0,0
3223,D & N Haveli,2007,District Jail,0,0,0,0,0,0,0,0,0,0,0,0,0,0,0
3224,D & N Haveli,2007,Sub_Jail,0,0,0,28,0,28,0,0,0,0,0,0,28,0,28
3225,D & N Haveli,2007,Women Jail,0,0,0,0,0,0,0,0,0,0,0,0,0,0,0
3226,D & N Haveli,2007,Borstal School,0,0,0,0,0,0,0,0,0,0,0,0,0,0,0
3227,D & N Haveli,2007,Open Jail,0,0,0,0,0,0,0,0,0,0,0,0,0,0,0
3228,D & N Haveli,2007,Special Jail,0,0,0,0,0,0,0,0,0,0,0,0,0,0,0
3229,D & N Haveli,2007,Others,0,0,0,0,0,0,0,0,0,0,0,0,0,0,0
3230,D & N Haveli,2007,Total,0,0,0,28,0,28,0,0,0,0,0,0,28,0,28
3231,D & N Haveli,2008,Central Jail,0,0,0,0,0,0,0,0,0,0,0,0,0,0,0
3232,D & N Haveli,2008,District Jail,0,0,0,0,0,0,0,0,0,0,0,0,0,0,0
3233,D & N Haveli,2008,Sub_Jail,11,0,11,32,3,35,0,0,0,0,0,0,43,3,46
3234,D & N Haveli,2008,Women Jail,0,0,0,0,0,0,0,0,0,0,0,0,0,0,0
3235,D & N Haveli,2008,Borstal School,0,0,0,0,0,0,0,0,0,0,0,0,0,0,0
3236,D & N Haveli,2008,Open Jail,0,0,0,0,0,0,0,0,0,0,0,0,0,0,0
3237,D & N Haveli,2008,Special Jail,0,0,0,0,0,0,0,0,0,0,0,0,0,0,0
3238,D & N Haveli,2008,Others,0,0,0,0,0,0,0,0,0,0,0,0,0,0,0
3239,D & N Haveli,2008,Total,11,0,11,32,3,35,0,0,0,0,0,0,43,3,46
3240,D & N Haveli,2009,Central Jail,0,0,0,0,0,0,0,0,0,0,0,0,0,0,0
3241,D & N Haveli,2009,District Jail,0,0,0,0,0,0,0,0,0,0,0,0,0,0,0
3242,D & N Haveli,2009,Sub_Jail,2,0,2,52,2,54,0,0,0,0,0,0,54,2,56
3243,D & N Haveli,2009,Women Jail,0,0,0,0,0,0,0,0,0,0,0,0,0,0,0
3244,D & N Haveli,2009,Borstal School,0,0,0,0,0,0,0,0,0,0,0,0,0,0,0
3245,D & N Haveli,2009,Open Jail,0,0,0,0,0,0,0,0,0,0,0,0,0,0,0
3246,D & N Haveli,2009,Special Jail,0,0,0,0,0,0,0,0,0,0,0,0,0,0,0
3247,D & N Haveli,2009,Others,0,0,0,0,0,0,0,0,0,0,0,0,0,0,0
3248,D & N Haveli,2009,Total,2,0,2,52,2,54,0,0,0,0,0,0,54,2,56
3249,D & N Haveli,2010,Central Jail,0,0,0,0,0,0,0,0,0,0,0,0,0,0,0
3250,D & N Haveli,2010,District Jail,0,0,0,0,0,0,0,0,0,0,0,0,0,0,0
3251,D & N Haveli,2010,Sub_Jail,0,0,0,42,0,42,0,0,0,0,0,0,42,0,42
3252,D & N Haveli,2010,Women Jail,0,0,0,0,0,0,0,0,0,0,0,0,0,0,0
3253,D & N Haveli,2010,Borstal School,0,0,0,0,0,0,0,0,0,0,0,0,0,0,0
3254,D & N Haveli,2010,Open Jail,0,0,0,0,0,0,0,0,0,0,0,0,0,0,0
3255,D & N Haveli,2010,Special Jail,0,0,0,0,0,0,0,0,0,0,0,0,0,0,0
3256,D & N Haveli,2010,Others,0,0,0,0,0,0,0,0,0,0,0,0,0,0,0
3257,D & N Haveli,2010,Total,0,0,0,42,0,42,0,0,0,0,0,0,42,0,42
3258,D & N Haveli,2011,Central Jail,0,0,0,0,0,0,0,0,0,0,0,0,0,0,0
3259,D & N Haveli,2011,District Jail,0,0,0,0,0,0,0,0,0,0,0,0,0,0,0
3260,D & N Haveli,2011,Sub_Jail,0,0,0,23,2,25,0,0,0,0,0,0,23,2,25
3261,D & N Haveli,2011,Women Jail,0,0,0,0,0,0,0,0,0,0,0,0,0,0,0
3262,D & N Haveli,2011,Borstal School,0,0,0,0,0,0,0,0,0,0,0,0,0,0,0
3263,D & N Haveli,2011,Open Jail,0,0,0,0,0,0,0,0,0,0,0,0,0,0,0
3264,D & N Haveli,2011,Special Jail,0,0,0,0,0,0,0,0,0,0,0,0,0,0,0
3265,D & N Haveli,2011,Others,0,0,0,0,0,0,0,0,0,0,0,0,0,0,0
3266,D & N Haveli,2011,Total,0,0,0,23,2,25,0,0,0,0,0,0,23,2,25
3267,D & N Haveli,2012,Central Jail,0,0,0,0,0,0,0,0,0,0,0,0,0,0,0
3268,D & N Haveli,2012,District Jail,0,0,0,0,0,0,0,0,0,0,0,0,0,0,0
3269,D & N Haveli,2012,Sub_Jail,0,0,0,35,2,37,0,0,0,0,0,0,35,2,37
3270,D & N Haveli,2012,Women Jail,0,0,0,0,0,0,0,0,0,0,0,0,0,0,0
3271,D & N Haveli,2012,Borstal School,0,0,0,0,0,0,0,0,0,0,0,0,0,0,0
3272,D & N Haveli,2012,Open Jail,0,0,0,0,0,0,0,0,0,0,0,0,0,0,0
3273,D & N Haveli,2012,Special Jail,0,0,0,0,0,0,0,0,0,0,0,0,0,0,0
3274,D & N Haveli,2012,Others,0,0,0,0,0,0,0,0,0,0,0,0,0,0,0
3275,D & N Haveli,2012,Total,0,0,0,35,2,37,0,0,0,0,0,0,35,2,37
3276,Daman & Diu,2001,Central Jail,0,0,0,0,0,0,0,0,0,0,0,0,0,0,0
3277,Daman & Diu,2001,District Jail,0,0,0,0,0,0,0,0,0,0,0,0,0,0,0
3278,Daman & Diu,2001,Sub_Jail,23,0,23,17,1,18,0,0,0,0,0,0,40,1,41
3279,Daman & Diu,2001,Women Jail,0,0,0,0,0,0,0,0,0,0,0,0,0,0,0
3280,Daman & Diu,2001,Borstal School,0,0,0,0,0,0,0,0,0,0,0,0,0,0,0
3281,Daman & Diu,2001,Open Jail,0,0,0,0,0,0,0,0,0,0,0,0,0,0,0
3282,Daman & Diu,2001,Special Jail,0,0,0,0,0,0,0,0,0,0,0,0,0,0,0
3283,Daman & Diu,2001,Others,0,0,0,0,0,0,0,0,0,0,0,0,0,0,0
3284,Daman & Diu,2001,Total,23,0,23,17,1,18,0,0,0,0,0,0,40,1,41
3285,Daman & Diu,2002,Central Jail,0,0,0,0,0,0,0,0,0,0,0,0,0,0,0
3286,Daman & Diu,2002,District Jail,0,0,0,0,0,0,0,0,0,0,0,0,0,0,0
3287,Daman & Diu,2002,Sub_Jail,13,0,13,20,0,20,0,0,0,0,0,0,33,0,33
3288,Daman & Diu,2002,Women Jail,0,0,0,0,0,0,0,0,0,0,0,0,0,0,0
3289,Daman & Diu,2002,Borstal School,0,0,0,0,0,0,0,0,0,0,0,0,0,0,0
3290,Daman & Diu,2002,Open Jail,0,0,0,0,0,0,0,0,0,0,0,0,0,0,0
3291,Daman & Diu,2002,Special Jail,0,0,0,0,0,0,0,0,0,0,0,0,0,0,0
3292,Daman & Diu,2002,Others,0,0,0,0,0,0,0,0,0,0,0,0,0,0,0
3293,Daman & Diu,2002,Total,13,0,13,20,0,20,0,0,0,0,0,0,33,0,33
3294,Daman & Diu,2003,Central Jail,0,0,0,0,0,0,0,0,0,0,0,0,0,0,0
3295,Daman & Diu,2003,District Jail,0,0,0,0,0,0,0,0,0,0,0,0,0,0,0
3296,Daman & Diu,2003,Sub_Jail,13,0,13,20,0,20,0,0,0,0,0,0,33,0,33
3297,Daman & Diu,2003,Women Jail,0,0,0,0,0,0,0,0,0,0,0,0,0,0,0
3298,Daman & Diu,2003,Borstal School,0,0,0,0,0,0,0,0,0,0,0,0,0,0,0
3299,Daman & Diu,2003,Open Jail,0,0,0,0,0,0,0,0,0,0,0,0,0,0,0
3300,Daman & Diu,2003,Special Jail,0,0,0,0,0,0,0,0,0,0,0,0,0,0,0
3301,Daman & Diu,2003,Others,0,0,0,0,0,0,0,0,0,0,0,0,0,0,0
3302,Daman & Diu,2003,Total,13,0,13,20,0,20,0,0,0,0,0,0,33,0,33
3303,Daman & Diu,2004,Central Jail,0,0,0,0,0,0,0,0,0,0,0,0,0,0,0
3304,Daman & Diu,2004,District Jail,0,0,0,0,0,0,0,0,0,0,0,0,0,0,0
3305,Daman & Diu,2004,Sub_Jail,8,0,8,18,1,19,0,0,0,0,0,0,26,1,27
3306,Daman & Diu,2004,Women Jail,0,0,0,0,0,0,0,0,0,0,0,0,0,0,0
3307,Daman & Diu,2004,Borstal School,0,0,0,0,0,0,0,0,0,0,0,0,0,0,0
3308,Daman & Diu,2004,Open Jail,0,0,0,0,0,0,0,0,0,0,0,0,0,0,0
3309,Daman & Diu,2004,Special Jail,0,0,0,0,0,0,0,0,0,0,0,0,0,0,0
3310,Daman & Diu,2004,Others,0,0,0,0,0,0,0,0,0,0,0,0,0,0,0
3311,Daman & Diu,2004,Total,8,0,8,18,1,19,0,0,0,0,0,0,26,1,27
3312,Daman & Diu,2005,Central Jail,0,0,0,0,0,0,0,0,0,0,0,0,0,0,0
3313,Daman & Diu,2005,District Jail,0,0,0,0,0,0,0,0,0,0,0,0,0,0,0
3314,Daman & Diu,2005,Sub_Jail,11,0,11,23,1,24,0,0,0,0,0,0,34,1,35
3315,Daman & Diu,2005,Women Jail,0,0,0,0,0,0,0,0,0,0,0,0,0,0,0
3316,Daman & Diu,2005,Borstal School,0,0,0,0,0,0,0,0,0,0,0,0,0,0,0
3317,Daman & Diu,2005,Open Jail,0,0,0,0,0,0,0,0,0,0,0,0,0,0,0
3318,Daman & Diu,2005,Special Jail,0,0,0,0,0,0,0,0,0,0,0,0,0,0,0
3319,Daman & Diu,2005,Others,0,0,0,0,0,0,0,0,0,0,0,0,0,0,0
3320,Daman & Diu,2005,Total,11,0,11,23,1,24,0,0,0,0,0,0,34,1,35
3321,Daman & Diu,2006,Central Jail,0,0,0,0,0,0,0,0,0,0,0,0,0,0,0
3322,Daman & Diu,2006,District Jail,0,0,0,0,0,0,0,0,0,0,0,0,0,0,0
3323,Daman & Diu,2006,Sub_Jail,12,0,12,41,1,42,0,0,0,0,0,0,53,1,54
3324,Daman & Diu,2006,Women Jail,0,0,0,0,0,0,0,0,0,0,0,0,0,0,0
3325,Daman & Diu,2006,Borstal School,0,0,0,0,0,0,0,0,0,0,0,0,0,0,0
3326,Daman & Diu,2006,Open Jail,0,0,0,0,0,0,0,0,0,0,0,0,0,0,0
3327,Daman & Diu,2006,Special Jail,0,0,0,0,0,0,0,0,0,0,0,0,0,0,0
3328,Daman & Diu,2006,Others,0,0,0,0,0,0,0,0,0,0,0,0,0,0,0
3329,Daman & Diu,2006,Total,12,0,12,41,1,42,0,0,0,0,0,0,53,1,54
3330,Daman & Diu,2007,Central Jail,0,0,0,0,0,0,0,0,0,0,0,0,0,0,0
3331,Daman & Diu,2007,District Jail,0,0,0,0,0,0,0,0,0,0,0,0,0,0,0
3332,Daman & Diu,2007,Sub_Jail,8,2,10,52,4,56,0,0,0,0,0,0,60,6,66
3333,Daman & Diu,2007,Women Jail,0,0,0,0,0,0,0,0,0,0,0,0,0,0,0
3334,Daman & Diu,2007,Borstal School,0,0,0,0,0,0,0,0,0,0,0,0,0,0,0
3335,Daman & Diu,2007,Open Jail,0,0,0,0,0,0,0,0,0,0,0,0,0,0,0
3336,Daman & Diu,2007,Special Jail,0,0,0,0,0,0,0,0,0,0,0,0,0,0,0
3337,Daman & Diu,2007,Others,0,0,0,0,0,0,0,0,0,0,0,0,0,0,0
3338,Daman & Diu,2007,Total,8,2,10,52,4,56,0,0,0,0,0,0,60,6,66
3339,Daman & Diu,2008,Central Jail,0,0,0,0,0,0,0,0,0,0,0,0,0,0,0
3340,Daman & Diu,2008,District Jail,0,0,0,0,0,0,0,0,0,0,0,0,0,0,0
3341,Daman & Diu,2008,Sub_Jail,14,2,16,26,1,27,0,0,0,0,0,0,40,3,43
3342,Daman & Diu,2008,Women Jail,0,0,0,0,0,0,0,0,0,0,0,0,0,0,0
3343,Daman & Diu,2008,Borstal School,0,0,0,0,0,0,0,0,0,0,0,0,0,0,0
3344,Daman & Diu,2008,Open Jail,0,0,0,0,0,0,0,0,0,0,0,0,0,0,0
3345,Daman & Diu,2008,Special Jail,0,0,0,0,0,0,0,0,0,0,0,0,0,0,0
3346,Daman & Diu,2008,Others,0,0,0,0,0,0,0,0,0,0,0,0,0,0,0
3347,Daman & Diu,2008,Total,14,2,16,26,1,27,0,0,0,0,0,0,40,3,43
3348,Daman & Diu,2009,Central Jail,0,0,0,0,0,0,0,0,0,0,0,0,0,0,0
3349,Daman & Diu,2009,District Jail,0,0,0,0,0,0,0,0,0,0,0,0,0,0,0
3350,Daman & Diu,2009,Sub_Jail,15,1,16,24,0,24,0,0,0,0,0,0,39,1,40
3351,Daman & Diu,2009,Women Jail,0,0,0,0,0,0,0,0,0,0,0,0,0,0,0
3352,Daman & Diu,2009,Borstal School,0,0,0,0,0,0,0,0,0,0,0,0,0,0,0
3353,Daman & Diu,2009,Open Jail,0,0,0,0,0,0,0,0,0,0,0,0,0,0,0
3354,Daman & Diu,2009,Special Jail,0,0,0,0,0,0,0,0,0,0,0,0,0,0,0
3355,Daman & Diu,2009,Others,0,0,0,0,0,0,0,0,0,0,0,0,0,0,0
3356,Daman & Diu,2009,Total,15,1,16,24,0,24,0,0,0,0,0,0,39,1,40
3357,Daman & Diu,2010,Central Jail,0,0,0,0,0,0,0,0,0,0,0,0,0,0,0
3358,Daman & Diu,2010,District Jail,0,0,0,0,0,0,0,0,0,0,0,0,0,0,0
3359,Daman & Diu,2010,Sub_Jail,13,1,14,16,0,16,0,0,0,0,0,0,29,1,30
3360,Daman & Diu,2010,Women Jail,0,0,0,0,0,0,0,0,0,0,0,0,0,0,0
3361,Daman & Diu,2010,Borstal School,0,0,0,0,0,0,0,0,0,0,0,0,0,0,0
3362,Daman & Diu,2010,Open Jail,0,0,0,0,0,0,0,0,0,0,0,0,0,0,0
3363,Daman & Diu,2010,Special Jail,0,0,0,0,0,0,0,0,0,0,0,0,0,0,0
3364,Daman & Diu,2010,Others,0,0,0,0,0,0,0,0,0,0,0,0,0,0,0
3365,Daman & Diu,2010,Total,13,1,14,16,0,16,0,0,0,0,0,0,29,1,30
3366,Daman & Diu,2011,Central Jail,0,0,0,0,0,0,0,0,0,0,0,0,0,0,0
3367,Daman & Diu,2011,District Jail,0,0,0,0,0,0,0,0,0,0,0,0,0,0,0
3368,Daman & Diu,2011,Sub_Jail,11,1,12,17,0,17,0,0,0,0,0,0,28,1,29
3369,Daman & Diu,2011,Women Jail,0,0,0,0,0,0,0,0,0,0,0,0,0,0,0
3370,Daman & Diu,2011,Borstal School,0,0,0,0,0,0,0,0,0,0,0,0,0,0,0
3371,Daman & Diu,2011,Open Jail,0,0,0,0,0,0,0,0,0,0,0,0,0,0,0
3372,Daman & Diu,2011,Special Jail,0,0,0,0,0,0,0,0,0,0,0,0,0,0,0
3373,Daman & Diu,2011,Others,0,0,0,0,0,0,0,0,0,0,0,0,0,0,0
3374,Daman & Diu,2011,Total,11,1,12,17,0,17,0,0,0,0,0,0,28,1,29
3375,Daman & Diu,2012,Central Jail,0,0,0,0,0,0,0,0,0,0,0,0,0,0,0
3376,Daman & Diu,2012,District Jail,0,0,0,0,0,0,0,0,0,0,0,0,0,0,0
3377,Daman & Diu,2012,Sub_Jail,13,1,14,10,1,11,0,0,0,0,0,0,23,2,25
3378,Daman & Diu,2012,Women Jail,0,0,0,0,0,0,0,0,0,0,0,0,0,0,0
3379,Daman & Diu,2012,Borstal School,0,0,0,0,0,0,0,0,0,0,0,0,0,0,0
3380,Daman & Diu,2012,Open Jail,0,0,0,0,0,0,0,0,0,0,0,0,0,0,0
3381,Daman & Diu,2012,Special Jail,0,0,0,0,0,0,0,0,0,0,0,0,0,0,0
3382,Daman & Diu,2012,Others,0,0,0,0,0,0,0,0,0,0,0,0,0,0,0
3383,Daman & Diu,2012,Total,13,1,14,10,1,11,0,0,0,0,0,0,23,2,25
3384,Delhi,2001,Central Jail,2104,0,2104,8366,0,8366,49,0,49,0,0,0,10519,0,10519
3385,Delhi,2001,District Jail,0,0,0,0,0,0,0,0,0,0,0,0,0,0,0
3386,Delhi,2001,Sub_Jail,0,0,0,0,0,0,0,0,0,0,0,0,0,0,0
3387,Delhi,2001,Women Jail,0,117,117,0,386,386,0,1,1,0,0,0,0,504,504
3388,Delhi,2001,Borstal School,0,0,0,0,0,0,0,0,0,0,0,0,0,0,0
3389,Delhi,2001,Open Jail,0,0,0,0,0,0,0,0,0,0,0,0,0,0,0
3390,Delhi,2001,Special Jail,0,0,0,0,0,0,0,0,0,0,0,0,0,0,0
3391,Delhi,2001,Others,0,0,0,0,0,0,0,0,0,0,0,0,0,0,0
3392,Delhi,2001,Total,2104,117,2221,8366,386,8752,49,1,50,0,0,0,10519,504,11023
3393,Delhi,2002,Central Jail,2218,0,2218,9275,0,9275,51,0,51,0,0,0,11544,0,11544
3394,Delhi,2002,District Jail,0,0,0,0,0,0,0,0,0,0,0,0,0,0,0
3395,Delhi,2002,Sub_Jail,0,0,0,0,0,0,0,0,0,0,0,0,0,0,0
3396,Delhi,2002,Women Jail,0,115,115,0,381,381,0,1,1,0,0,0,0,497,497
3397,Delhi,2002,Borstal School,0,0,0,0,0,0,0,0,0,0,0,0,0,0,0
3398,Delhi,2002,Open Jail,0,0,0,0,0,0,0,0,0,0,0,0,0,0,0
3399,Delhi,2002,Special Jail,0,0,0,0,0,0,0,0,0,0,0,0,0,0,0
3400,Delhi,2002,Others,0,0,0,0,0,0,0,0,0,0,0,0,0,0,0
3401,Delhi,2002,Total,2218,115,2333,9275,381,9656,51,1,52,0,0,0,11544,497,12041
3402,Delhi,2003,Central Jail,2152,0,2152,9431,0,9431,39,0,39,0,0,0,11622,0,11622
3403,Delhi,2003,District Jail,0,0,0,0,0,0,0,0,0,0,0,0,0,0,0
3404,Delhi,2003,Sub_Jail,0,0,0,0,0,0,0,0,0,0,0,0,0,0,0
3405,Delhi,2003,Women Jail,0,114,114,0,435,435,0,1,1,0,0,0,0,550,550
3406,Delhi,2003,Borstal School,0,0,0,0,0,0,0,0,0,0,0,0,0,0,0
3407,Delhi,2003,Open Jail,0,0,0,0,0,0,0,0,0,0,0,0,0,0,0
3408,Delhi,2003,Special Jail,0,0,0,0,0,0,0,0,0,0,0,0,0,0,0
3409,Delhi,2003,Others,0,0,0,0,0,0,0,0,0,0,0,0,0,0,0
3410,Delhi,2003,Total,2152,114,2266,9431,435,9866,39,1,40,0,0,0,11622,550,12172
3411,Delhi,2004,Central Jail,1774,0,1774,9688,0,9688,15,0,15,0,0,0,11477,0,11477
3412,Delhi,2004,District Jail,602,0,602,0,0,0,0,0,0,0,0,0,602,0,602
3413,Delhi,2004,Sub_Jail,0,0,0,0,0,0,0,0,0,0,0,0,0,0,0
3414,Delhi,2004,Women Jail,0,132,132,0,399,399,0,0,0,0,0,0,0,531,531
3415,Delhi,2004,Borstal School,0,0,0,0,0,0,0,0,0,0,0,0,0,0,0
3416,Delhi,2004,Open Jail,0,0,0,0,0,0,0,0,0,0,0,0,0,0,0
3417,Delhi,2004,Special Jail,0,0,0,0,0,0,0,0,0,0,0,0,0,0,0
3418,Delhi,2004,Others,0,0,0,0,0,0,0,0,0,0,0,0,0,0,0
3419,Delhi,2004,Total,2376,132,2508,9688,399,10087,15,0,15,0,0,0,12079,531,12610
3420,Delhi,2005,Central Jail,1412,0,1412,9415,0,9415,12,0,12,0,0,0,10839,0,10839
3421,Delhi,2005,District Jail,981,0,981,6,0,6,4,0,4,0,0,0,991,0,991
3422,Delhi,2005,Sub_Jail,0,0,0,0,0,0,0,0,0,0,0,0,0,0,0
3423,Delhi,2005,Women Jail,0,117,117,0,370,370,0,0,0,0,0,0,0,487,487
3424,Delhi,2005,Borstal School,0,0,0,0,0,0,0,0,0,0,0,0,0,0,0
3425,Delhi,2005,Open Jail,0,0,0,0,0,0,0,0,0,0,0,0,0,0,0
3426,Delhi,2005,Special Jail,0,0,0,0,0,0,0,0,0,0,0,0,0,0,0
3427,Delhi,2005,Others,0,0,0,0,0,0,0,0,0,0,0,0,0,0,0
3428,Delhi,2005,Total,2393,117,2510,9421,370,9791,16,0,16,0,0,0,11830,487,12317
3429,Delhi,2006,Central Jail,2233,0,2233,9129,0,9129,16,0,16,0,0,0,11378,0,11378
3430,Delhi,2006,District Jail,137,0,137,1422,0,1422,0,0,0,0,0,0,1559,0,1559
3431,Delhi,2006,Sub_Jail,0,0,0,0,0,0,0,0,0,0,0,0,0,0,0
3432,Delhi,2006,Women Jail,0,79,79,0,383,383,0,1,1,0,0,0,0,463,463
3433,Delhi,2006,Borstal School,0,0,0,0,0,0,0,0,0,0,0,0,0,0,0
3434,Delhi,2006,Open Jail,0,0,0,0,0,0,0,0,0,0,0,0,0,0,0
3435,Delhi,2006,Special Jail,0,0,0,0,0,0,0,0,0,0,0,0,0,0,0
3436,Delhi,2006,Others,0,0,0,0,0,0,0,0,0,0,0,0,0,0,0
3437,Delhi,2006,Total,2370,79,2449,10551,383,10934,16,1,17,0,0,0,12937,463,13400
3438,Delhi,2007,Central Jail,2072,0,2072,7429,0,7429,22,0,22,0,0,0,9523,0,9523
3439,Delhi,2007,District Jail,133,0,133,1463,0,1463,1,0,1,0,0,0,1597,0,1597
3440,Delhi,2007,Sub_Jail,0,0,0,0,0,0,0,0,0,0,0,0,0,0,0
3441,Delhi,2007,Women Jail,0,63,63,0,422,422,0,0,0,0,0,0,0,485,485
3442,Delhi,2007,Borstal School,0,0,0,0,0,0,0,0,0,0,0,0,0,0,0
3443,Delhi,2007,Open Jail,0,0,0,0,0,0,0,0,0,0,0,0,0,0,0
3444,Delhi,2007,Special Jail,0,0,0,0,0,0,0,0,0,0,0,0,0,0,0
3445,Delhi,2007,Others,0,0,0,0,0,0,0,0,0,0,0,0,0,0,0
3446,Delhi,2007,Total,2205,63,2268,8892,422,9314,23,0,23,0,0,0,11120,485,11605
3447,Delhi,2008,Central Jail,1775,0,1775,7603,0,7603,19,0,19,4,0,4,9401,0,9401
3448,Delhi,2008,District Jail,147,0,147,1535,0,1535,0,0,0,0,0,0,1682,0,1682
3449,Delhi,2008,Sub_Jail,0,0,0,0,0,0,0,0,0,0,0,0,0,0,0
3450,Delhi,2008,Women Jail,0,56,56,0,414,414,0,0,0,0,0,0,0,470,470
3451,Delhi,2008,Borstal School,0,0,0,0,0,0,0,0,0,0,0,0,0,0,0
3452,Delhi,2008,Open Jail,0,0,0,0,0,0,0,0,0,0,0,0,0,0,0
3453,Delhi,2008,Special Jail,0,0,0,0,0,0,0,0,0,0,0,0,0,0,0
3454,Delhi,2008,Others,0,0,0,0,0,0,0,0,0,0,0,0,0,0,0
3455,Delhi,2008,Total,1922,56,1978,9138,414,9552,19,0,19,4,0,4,11083,470,11553
3456,Delhi,2009,Central Jail,2069,0,2069,7253,0,7253,15,0,15,5,0,5,9342,0,9342
3457,Delhi,2009,District Jail,143,0,143,1314,0,1314,0,0,0,0,0,0,1457,0,1457
3458,Delhi,2009,Sub_Jail,0,0,0,0,0,0,0,0,0,0,0,0,0,0,0
3459,Delhi,2009,Women Jail,0,83,83,0,364,364,0,0,0,0,0,0,0,447,447
3460,Delhi,2009,Borstal School,0,0,0,0,0,0,0,0,0,0,0,0,0,0,0
3461,Delhi,2009,Open Jail,0,0,0,0,0,0,0,0,0,0,0,0,0,0,0
3462,Delhi,2009,Special Jail,0,0,0,0,0,0,0,0,0,0,0,0,0,0,0
3463,Delhi,2009,Others,0,0,0,0,0,0,0,0,0,0,0,0,0,0,0
3464,Delhi,2009,Total,2212,83,2295,8567,364,8931,15,0,15,5,0,5,10799,447,11246
3465,Delhi,2010,Central Jail,2500,0,2500,6401,0,6401,13,0,13,5,0,5,8919,0,8919
3466,Delhi,2010,District Jail,147,0,147,1285,0,1285,0,0,0,0,0,0,1432,0,1432
3467,Delhi,2010,Sub_Jail,0,0,0,0,0,0,0,0,0,0,0,0,0,0,0
3468,Delhi,2010,Women Jail,0,104,104,0,401,401,0,0,0,0,0,0,0,505,505
3469,Delhi,2010,Borstal School,0,0,0,0,0,0,0,0,0,0,0,0,0,0,0
3470,Delhi,2010,Open Jail,0,0,0,0,0,0,0,0,0,0,0,0,0,0,0
3471,Delhi,2010,Special Jail,0,0,0,0,0,0,0,0,0,0,0,0,0,0,0
3472,Delhi,2010,Others,0,0,0,0,0,0,0,0,0,0,0,0,0,0,0
3473,Delhi,2010,Total,2647,104,2751,7686,401,8087,13,0,13,5,0,5,10351,505,10856
3474,Delhi,2011,Central Jail,2921,0,2921,7246,0,7246,6,0,6,0,0,0,10173,0,10173
3475,Delhi,2011,District Jail,170,0,170,1255,0,1255,0,0,0,0,0,0,1425,0,1425
3476,Delhi,2011,Sub_Jail,0,0,0,0,0,0,0,0,0,0,0,0,0,0,0
3477,Delhi,2011,Women Jail,0,116,116,0,410,410,0,0,0,0,0,0,0,526,526
3478,Delhi,2011,Borstal School,0,0,0,0,0,0,0,0,0,0,0,0,0,0,0
3479,Delhi,2011,Open Jail,0,0,0,0,0,0,0,0,0,0,0,0,0,0,0
3480,Delhi,2011,Special Jail,0,0,0,0,0,0,0,0,0,0,0,0,0,0,0
3481,Delhi,2011,Others,0,0,0,0,0,0,0,0,0,0,0,0,0,0,0
3482,Delhi,2011,Total,3091,116,3207,8501,410,8911,6,0,6,0,0,0,11598,526,12124
3483,Delhi,2012,Central Jail,2881,0,2881,7105,0,7105,5,0,5,2,0,2,9993,0,9993
3484,Delhi,2012,District Jail,213,0,213,1367,0,1367,0,0,0,0,0,0,1580,0,1580
3485,Delhi,2012,Sub_Jail,0,0,0,0,0,0,0,0,0,0,0,0,0,0,0
3486,Delhi,2012,Women Jail,0,125,125,0,415,415,0,0,0,0,0,0,0,540,540
3487,Delhi,2012,Borstal School,0,0,0,0,0,0,0,0,0,0,0,0,0,0,0
3488,Delhi,2012,Open Jail,0,0,0,0,0,0,0,0,0,0,0,0,0,0,0
3489,Delhi,2012,Special Jail,0,0,0,0,0,0,0,0,0,0,0,0,0,0,0
3490,Delhi,2012,Others,0,0,0,0,0,0,0,0,0,0,0,0,0,0,0
3491,Delhi,2012,Total,3094,125,3219,8472,415,8887,5,0,5,2,0,2,11573,540,12113
3492,Lakshadweep,2001,Central Jail,0,0,0,0,0,0,0,0,0,0,0,0,0,0,0
3493,Lakshadweep,2001,District Jail,0,0,0,0,0,0,0,0,0,0,0,0,0,0,0
3494,Lakshadweep,2001,Sub_Jail,0,0,0,1,0,1,0,0,0,0,0,0,1,0,1
3495,Lakshadweep,2001,Women Jail,0,0,0,0,0,0,0,0,0,0,0,0,0,0,0
3496,Lakshadweep,2001,Borstal School,0,0,0,0,0,0,0,0,0,0,0,0,0,0,0
3497,Lakshadweep,2001,Open Jail,0,0,0,0,0,0,0,0,0,0,0,0,0,0,0
3498,Lakshadweep,2001,Special Jail,0,0,0,0,0,0,0,0,0,0,0,0,0,0,0
3499,Lakshadweep,2001,Others,0,0,0,0,0,0,0,0,0,0,0,0,0,0,0
3500,Lakshadweep,2001,Total,0,0,0,1,0,1,0,0,0,0,0,0,1,0,1
3501,Lakshadweep,2002,Central Jail,0,0,0,0,0,0,0,0,0,0,0,0,0,0,0
3502,Lakshadweep,2002,District Jail,0,0,0,0,0,0,0,0,0,0,0,0,0,0,0
3503,Lakshadweep,2002,Sub_Jail,2,0,2,14,0,14,0,0,0,0,0,0,16,0,16
3504,Lakshadweep,2002,Women Jail,0,0,0,0,0,0,0,0,0,0,0,0,0,0,0
3505,Lakshadweep,2002,Borstal School,0,0,0,0,0,0,0,0,0,0,0,0,0,0,0
3506,Lakshadweep,2002,Open Jail,0,0,0,0,0,0,0,0,0,0,0,0,0,0,0
3507,Lakshadweep,2002,Special Jail,0,0,0,0,0,0,0,0,0,0,0,0,0,0,0
3508,Lakshadweep,2002,Others,0,0,0,0,0,0,0,0,0,0,0,0,0,0,0
3509,Lakshadweep,2002,Total,2,0,2,14,0,14,0,0,0,0,0,0,16,0,16
3510,Lakshadweep,2003,Central Jail,0,0,0,0,0,0,0,0,0,0,0,0,0,0,0
3511,Lakshadweep,2003,District Jail,0,0,0,0,0,0,0,0,0,0,0,0,0,0,0
3512,Lakshadweep,2003,Sub_Jail,0,0,0,4,0,4,0,0,0,0,0,0,4,0,4
3513,Lakshadweep,2003,Women Jail,0,0,0,0,0,0,0,0,0,0,0,0,0,0,0
3514,Lakshadweep,2003,Borstal School,0,0,0,0,0,0,0,0,0,0,0,0,0,0,0
3515,Lakshadweep,2003,Open Jail,0,0,0,0,0,0,0,0,0,0,0,0,0,0,0
3516,Lakshadweep,2003,Special Jail,0,0,0,0,0,0,0,0,0,0,0,0,0,0,0
3517,Lakshadweep,2003,Others,0,0,0,0,0,0,0,0,0,0,0,0,0,0,0
3518,Lakshadweep,2003,Total,0,0,0,4,0,4,0,0,0,0,0,0,4,0,4
3519,Lakshadweep,2004,Central Jail,0,0,0,0,0,0,0,0,0,0,0,0,0,0,0
3520,Lakshadweep,2004,District Jail,0,0,0,0,0,0,0,0,0,0,0,0,0,0,0
3521,Lakshadweep,2004,Sub_Jail,0,0,0,0,0,0,0,0,0,0,0,0,0,0,0
3522,Lakshadweep,2004,Women Jail,0,0,0,0,0,0,0,0,0,0,0,0,0,0,0
3523,Lakshadweep,2004,Borstal School,0,0,0,0,0,0,0,0,0,0,0,0,0,0,0
3524,Lakshadweep,2004,Open Jail,0,0,0,0,0,0,0,0,0,0,0,0,0,0,0
3525,Lakshadweep,2004,Special Jail,0,0,0,0,0,0,0,0,0,0,0,0,0,0,0
3526,Lakshadweep,2004,Others,0,0,0,0,0,0,0,0,0,0,0,0,0,0,0
3527,Lakshadweep,2004,Total,0,0,0,0,0,0,0,0,0,0,0,0,0,0,0
3528,Lakshadweep,2005,Central Jail,0,0,0,0,0,0,0,0,0,0,0,0,0,0,0
3529,Lakshadweep,2005,District Jail,0,0,0,0,0,0,0,0,0,0,0,0,0,0,0
3530,Lakshadweep,2005,Sub_Jail,0,0,0,6,0,6,0,0,0,0,0,0,6,0,6
3531,Lakshadweep,2005,Women Jail,0,0,0,0,0,0,0,0,0,0,0,0,0,0,0
3532,Lakshadweep,2005,Borstal School,0,0,0,0,0,0,0,0,0,0,0,0,0,0,0
3533,Lakshadweep,2005,Open Jail,0,0,0,0,0,0,0,0,0,0,0,0,0,0,0
3534,Lakshadweep,2005,Special Jail,0,0,0,0,0,0,0,0,0,0,0,0,0,0,0
3535,Lakshadweep,2005,Others,0,0,0,0,0,0,0,0,0,0,0,0,0,0,0
3536,Lakshadweep,2005,Total,0,0,0,6,0,6,0,0,0,0,0,0,6,0,6
3537,Lakshadweep,2006,Central Jail,0,0,0,0,0,0,0,0,0,0,0,0,0,0,0
3538,Lakshadweep,2006,District Jail,0,0,0,0,0,0,0,0,0,0,0,0,0,0,0
3539,Lakshadweep,2006,Sub_Jail,0,0,0,0,0,0,0,0,0,0,0,0,0,0,0
3540,Lakshadweep,2006,Women Jail,0,0,0,0,0,0,0,0,0,0,0,0,0,0,0
3541,Lakshadweep,2006,Borstal School,0,0,0,0,0,0,0,0,0,0,0,0,0,0,0
3542,Lakshadweep,2006,Open Jail,0,0,0,0,0,0,0,0,0,0,0,0,0,0,0
3543,Lakshadweep,2006,Special Jail,0,0,0,0,0,0,0,0,0,0,0,0,0,0,0
3544,Lakshadweep,2006,Others,0,0,0,0,0,0,0,0,0,0,0,0,0,0,0
3545,Lakshadweep,2006,Total,0,0,0,0,0,0,0,0,0,0,0,0,0,0,0
3546,Lakshadweep,2007,Central Jail,0,0,0,0,0,0,0,0,0,0,0,0,0,0,0
3547,Lakshadweep,2007,District Jail,0,0,0,0,0,0,0,0,0,0,0,0,0,0,0
3548,Lakshadweep,2007,Sub_Jail,3,0,3,11,0,11,0,0,0,8,0,8,22,0,22
3549,Lakshadweep,2007,Women Jail,0,0,0,0,0,0,0,0,0,0,0,0,0,0,0
3550,Lakshadweep,2007,Borstal School,0,0,0,0,0,0,0,0,0,0,0,0,0,0,0
3551,Lakshadweep,2007,Open Jail,0,0,0,0,0,0,0,0,0,0,0,0,0,0,0
3552,Lakshadweep,2007,Special Jail,0,0,0,0,0,0,0,0,0,0,0,0,0,0,0
3553,Lakshadweep,2007,Others,0,0,0,0,0,0,0,0,0,0,0,0,0,0,0
3554,Lakshadweep,2007,Total,3,0,3,11,0,11,0,0,0,8,0,8,22,0,22
3555,Lakshadweep,2008,Central Jail,0,0,0,0,0,0,0,0,0,0,0,0,0,0,0
3556,Lakshadweep,2008,District Jail,0,0,0,0,0,0,0,0,0,0,0,0,0,0,0
3557,Lakshadweep,2008,Sub_Jail,0,0,0,19,0,19,0,0,0,0,0,0,19,0,19
3558,Lakshadweep,2008,Women Jail,0,0,0,0,0,0,0,0,0,0,0,0,0,0,0
3559,Lakshadweep,2008,Borstal School,0,0,0,0,0,0,0,0,0,0,0,0,0,0,0
3560,Lakshadweep,2008,Open Jail,0,0,0,0,0,0,0,0,0,0,0,0,0,0,0
3561,Lakshadweep,2008,Special Jail,0,0,0,0,0,0,0,0,0,0,0,0,0,0,0
3562,Lakshadweep,2008,Others,0,0,0,0,0,0,0,0,0,0,0,0,0,0,0
3563,Lakshadweep,2008,Total,0,0,0,19,0,19,0,0,0,0,0,0,19,0,19
3564,Lakshadweep,2009,Central Jail,0,0,0,0,0,0,0,0,0,0,0,0,0,0,0
3565,Lakshadweep,2009,District Jail,0,0,0,0,0,0,0,0,0,0,0,0,0,0,0
3566,Lakshadweep,2009,Sub_Jail,1,0,1,43,0,43,0,0,0,0,0,0,44,0,44
3567,Lakshadweep,2009,Women Jail,0,0,0,0,0,0,0,0,0,0,0,0,0,0,0
3568,Lakshadweep,2009,Borstal School,0,0,0,0,0,0,0,0,0,0,0,0,0,0,0
3569,Lakshadweep,2009,Open Jail,0,0,0,0,0,0,0,0,0,0,0,0,0,0,0
3570,Lakshadweep,2009,Special Jail,0,0,0,0,0,0,0,0,0,0,0,0,0,0,0
3571,Lakshadweep,2009,Others,0,0,0,0,0,0,0,0,0,0,0,0,0,0,0
3572,Lakshadweep,2009,Total,1,0,1,43,0,43,0,0,0,0,0,0,44,0,44
3573,Lakshadweep,2010,Central Jail,0,0,0,0,0,0,0,0,0,0,0,0,0,0,0
3574,Lakshadweep,2010,District Jail,0,0,0,0,0,0,0,0,0,0,0,0,0,0,0
3575,Lakshadweep,2010,Sub_Jail,0,0,0,27,0,27,0,0,0,0,0,0,27,0,27
3576,Lakshadweep,2010,Women Jail,0,0,0,0,0,0,0,0,0,0,0,0,0,0,0
3577,Lakshadweep,2010,Borstal School,0,0,0,0,0,0,0,0,0,0,0,0,0,0,0
3578,Lakshadweep,2010,Open Jail,0,0,0,0,0,0,0,0,0,0,0,0,0,0,0
3579,Lakshadweep,2010,Special Jail,0,0,0,0,0,0,0,0,0,0,0,0,0,0,0
3580,Lakshadweep,2010,Others,0,0,0,0,0,0,0,0,0,0,0,0,0,0,0
3581,Lakshadweep,2010,Total,0,0,0,27,0,27,0,0,0,0,0,0,27,0,27
3582,Lakshadweep,2011,Central Jail,0,0,0,0,0,0,0,0,0,0,0,0,0,0,0
3583,Lakshadweep,2011,District Jail,0,0,0,0,0,0,0,0,0,0,0,0,0,0,0
3584,Lakshadweep,2011,Sub_Jail,0,0,0,29,1,30,50,0,50,0,0,0,79,1,80
3585,Lakshadweep,2011,Women Jail,0,0,0,0,0,0,0,0,0,0,0,0,0,0,0
3586,Lakshadweep,2011,Borstal School,0,0,0,0,0,0,0,0,0,0,0,0,0,0,0
3587,Lakshadweep,2011,Open Jail,0,0,0,0,0,0,0,0,0,0,0,0,0,0,0
3588,Lakshadweep,2011,Special Jail,0,0,0,0,0,0,0,0,0,0,0,0,0,0,0
3589,Lakshadweep,2011,Others,0,0,0,0,0,0,0,0,0,0,0,0,0,0,0
3590,Lakshadweep,2011,Total,0,0,0,29,1,30,50,0,50,0,0,0,79,1,80
3591,Lakshadweep,2012,Central Jail,0,0,0,0,0,0,0,0,0,0,0,0,0,0,0
3592,Lakshadweep,2012,District Jail,0,0,0,0,0,0,0,0,0,0,0,0,0,0,0
3593,Lakshadweep,2012,Sub_Jail,0,0,0,0,0,0,0,0,0,0,0,0,0,0,0
3594,Lakshadweep,2012,Women Jail,0,0,0,0,0,0,0,0,0,0,0,0,0,0,0
3595,Lakshadweep,2012,Borstal School,0,0,0,0,0,0,0,0,0,0,0,0,0,0,0
3596,Lakshadweep,2012,Open Jail,0,0,0,0,0,0,0,0,0,0,0,0,0,0,0
3597,Lakshadweep,2012,Special Jail,0,0,0,0,0,0,0,0,0,0,0,0,0,0,0
3598,Lakshadweep,2012,Others,0,0,0,0,0,0,0,0,0,0,0,0,0,0,0
3599,Lakshadweep,2012,Total,0,0,0,0,0,0,0,0,0,0,0,0,0,0,0
3600,Pondicherry,2001,Central Jail,99,1,100,141,3,144,0,0,0,0,0,0,240,4,244
3601,Pondicherry,2001,District Jail,7,0,7,7,2,9,0,0,0,0,0,0,14,2,16
3602,Pondicherry,2001,Sub_Jail,1,0,1,1,0,1,0,0,0,0,0,0,2,0,2
3603,Pondicherry,2001,Women Jail,0,0,0,0,0,0,0,0,0,0,0,0,0,0,0
3604,Pondicherry,2001,Borstal School,0,0,0,0,0,0,0,0,0,0,0,0,0,0,0
3605,Pondicherry,2001,Open Jail,0,0,0,0,0,0,0,0,0,0,0,0,0,0,0
3606,Pondicherry,2001,Special Jail,0,0,0,0,0,0,0,0,0,0,0,0,0,0,0
3607,Pondicherry,2001,Others,0,0,0,0,0,0,0,0,0,0,0,0,0,0,0
3608,Pondicherry,2001,Total,107,1,108,149,5,154,0,0,0,0,0,0,256,6,262
3609,Pondicherry,2002,Central Jail,109,1,110,80,12,92,0,0,0,0,0,0,189,13,202
3610,Pondicherry,2002,District Jail,20,0,20,18,0,18,0,0,0,0,0,0,38,0,38
3611,Pondicherry,2002,Sub_Jail,4,0,4,2,0,2,0,0,0,0,0,0,6,0,6
3612,Pondicherry,2002,Women Jail,0,0,0,0,0,0,0,0,0,0,0,0,0,0,0
3613,Pondicherry,2002,Borstal School,0,0,0,0,0,0,0,0,0,0,0,0,0,0,0
3614,Pondicherry,2002,Open Jail,0,0,0,0,0,0,0,0,0,0,0,0,0,0,0
3615,Pondicherry,2002,Special Jail,0,0,0,0,0,0,0,0,0,0,0,0,0,0,0
3616,Pondicherry,2002,Others,0,0,0,0,0,0,0,0,0,0,0,0,0,0,0
3617,Pondicherry,2002,Total,133,1,134,100,12,112,0,0,0,0,0,0,233,13,246
3618,Pondicherry,2003,Central Jail,119,2,121,121,4,125,0,0,0,0,0,0,240,6,246
3619,Pondicherry,2003,District Jail,0,0,0,0,0,0,0,0,0,0,0,0,0,0,0
3620,Pondicherry,2003,Sub_Jail,1,0,1,5,0,5,0,0,0,0,0,0,6,0,6
3621,Pondicherry,2003,Women Jail,0,0,0,0,0,0,0,0,0,0,0,0,0,0,0
3622,Pondicherry,2003,Borstal School,0,0,0,0,0,0,0,0,0,0,0,0,0,0,0
3623,Pondicherry,2003,Open Jail,0,0,0,0,0,0,0,0,0,0,0,0,0,0,0
3624,Pondicherry,2003,Special Jail,17,0,17,9,0,9,0,0,0,0,0,0,26,0,26
3625,Pondicherry,2003,Others,0,0,0,0,0,0,0,0,0,0,0,0,0,0,0
3626,Pondicherry,2003,Total,137,2,139,135,4,139,0,0,0,0,0,0,272,6,278
3627,Pondicherry,2004,Central Jail,94,2,96,150,0,150,0,0,0,0,0,0,244,2,246
3628,Pondicherry,2004,District Jail,11,0,11,38,1,39,0,0,0,0,0,0,49,1,50
3629,Pondicherry,2004,Sub_Jail,2,0,2,3,0,3,0,0,0,0,0,0,5,0,5
3630,Pondicherry,2004,Women Jail,0,0,0,0,0,0,0,0,0,0,0,0,0,0,0
3631,Pondicherry,2004,Borstal School,0,0,0,0,0,0,0,0,0,0,0,0,0,0,0
3632,Pondicherry,2004,Open Jail,0,0,0,0,0,0,0,0,0,0,0,0,0,0,0
3633,Pondicherry,2004,Special Jail,0,0,0,0,0,0,0,0,0,0,0,0,0,0,0
3634,Pondicherry,2004,Others,0,0,0,0,0,0,0,0,0,0,0,0,0,0,0
3635,Pondicherry,2004,Total,107,2,109,191,1,192,0,0,0,0,0,0,298,3,301
3636,Pondicherry,2005,Central Jail,109,5,114,137,1,138,0,0,0,0,0,0,246,6,252
3637,Pondicherry,2005,District Jail,5,0,5,26,0,26,0,0,0,0,0,0,31,0,31
3638,Pondicherry,2005,Sub_Jail,0,0,0,5,0,5,0,0,0,0,0,0,5,0,5
3639,Pondicherry,2005,Women Jail,0,0,0,0,0,0,0,0,0,0,0,0,0,0,0
3640,Pondicherry,2005,Borstal School,0,0,0,0,0,0,0,0,0,0,0,0,0,0,0
3641,Pondicherry,2005,Open Jail,0,0,0,0,0,0,0,0,0,0,0,0,0,0,0
3642,Pondicherry,2005,Special Jail,0,0,0,0,0,0,0,0,0,0,0,0,0,0,0
3643,Pondicherry,2005,Others,0,0,0,0,0,0,0,0,0,0,0,0,0,0,0
3644,Pondicherry,2005,Total,114,5,119,168,1,169,0,0,0,0,0,0,282,6,288
3645,Pondicherry,2006,Central Jail,84,3,87,139,1,140,0,0,0,0,0,0,223,4,227
3646,Pondicherry,2006,District Jail,20,0,20,58,0,58,0,0,0,0,0,0,78,0,78
3647,Pondicherry,2006,Sub_Jail,2,0,2,5,0,5,0,0,0,0,0,0,7,0,7
3648,Pondicherry,2006,Women Jail,0,0,0,0,0,0,0,0,0,0,0,0,0,0,0
3649,Pondicherry,2006,Borstal School,0,0,0,0,0,0,0,0,0,0,0,0,0,0,0
3650,Pondicherry,2006,Open Jail,0,0,0,0,0,0,0,0,0,0,0,0,0,0,0
3651,Pondicherry,2006,Special Jail,0,0,0,0,0,0,0,0,0,0,0,0,0,0,0
3652,Pondicherry,2006,Others,0,0,0,0,0,0,0,0,0,0,0,0,0,0,0
3653,Pondicherry,2006,Total,106,3,109,202,1,203,0,0,0,0,0,0,308,4,312
3654,Pondicherry,2007,Central Jail,83,2,85,194,2,196,0,0,0,0,0,0,277,4,281
3655,Pondicherry,2007,District Jail,24,0,24,26,0,26,0,0,0,0,0,0,50,0,50
3656,Pondicherry,2007,Sub_Jail,3,0,3,12,0,12,0,0,0,0,0,0,15,0,15
3657,Pondicherry,2007,Women Jail,0,0,0,0,0,0,0,0,0,0,0,0,0,0,0
3658,Pondicherry,2007,Borstal School,0,0,0,0,0,0,0,0,0,0,0,0,0,0,0
3659,Pondicherry,2007,Open Jail,0,0,0,0,0,0,0,0,0,0,0,0,0,0,0
3660,Pondicherry,2007,Special Jail,0,0,0,0,0,0,0,0,0,0,0,0,0,0,0
3661,Pondicherry,2007,Others,0,0,0,0,0,0,0,0,0,0,0,0,0,0,0
3662,Pondicherry,2007,Total,110,2,112,232,2,234,0,0,0,0,0,0,342,4,346
3663,Pondicherry,2008,Central Jail,80,1,81,156,5,161,0,0,0,0,0,0,236,6,242
3664,Pondicherry,2008,District Jail,16,0,16,33,0,33,0,0,0,0,0,0,49,0,49
3665,Pondicherry,2008,Sub_Jail,0,0,0,9,0,9,0,0,0,0,0,0,9,0,9
3666,Pondicherry,2008,Women Jail,0,0,0,0,0,0,0,0,0,0,0,0,0,0,0
3667,Pondicherry,2008,Borstal School,0,0,0,0,0,0,0,0,0,0,0,0,0,0,0
3668,Pondicherry,2008,Open Jail,0,0,0,0,0,0,0,0,0,0,0,0,0,0,0
3669,Pondicherry,2008,Special Jail,0,0,0,0,0,0,0,0,0,0,0,0,0,0,0
3670,Pondicherry,2008,Others,0,0,0,0,0,0,0,0,0,0,0,0,0,0,0
3671,Pondicherry,2008,Total,96,1,97,198,5,203,0,0,0,0,0,0,294,6,300
3672,Pondicherry,2009,Central Jail,100,2,102,116,1,117,0,0,0,0,0,0,216,3,219
3673,Pondicherry,2009,District Jail,16,0,16,33,0,33,0,0,0,0,0,0,49,0,49
3674,Pondicherry,2009,Sub_Jail,1,0,1,0,0,0,0,0,0,0,0,0,1,0,1
3675,Pondicherry,2009,Women Jail,0,0,0,0,0,0,0,0,0,0,0,0,0,0,0
3676,Pondicherry,2009,Borstal School,0,0,0,0,0,0,0,0,0,0,0,0,0,0,0
3677,Pondicherry,2009,Open Jail,0,0,0,0,0,0,0,0,0,0,0,0,0,0,0
3678,Pondicherry,2009,Special Jail,0,0,0,0,0,0,0,0,0,0,0,0,0,0,0
3679,Pondicherry,2009,Others,0,0,0,0,0,0,0,0,0,0,0,0,0,0,0
3680,Pondicherry,2009,Total,117,2,119,149,1,150,0,0,0,0,0,0,266,3,269
3681,Pondicherry,2010,Central Jail,99,2,101,96,4,100,3,0,3,0,0,0,198,6,204
3682,Pondicherry,2010,District Jail,29,0,29,26,0,26,0,0,0,0,0,0,55,0,55
3683,Pondicherry,2010,Sub_Jail,0,0,0,2,0,2,0,0,0,0,0,0,2,0,2
3684,Pondicherry,2010,Women Jail,0,0,0,0,0,0,0,0,0,0,0,0,0,0,0
3685,Pondicherry,2010,Borstal School,0,0,0,0,0,0,0,0,0,0,0,0,0,0,0
3686,Pondicherry,2010,Open Jail,0,0,0,0,0,0,0,0,0,0,0,0,0,0,0
3687,Pondicherry,2010,Special Jail,0,0,0,0,0,0,0,0,0,0,0,0,0,0,0
3688,Pondicherry,2010,Others,0,0,0,0,0,0,0,0,0,0,0,0,0,0,0
3689,Pondicherry,2010,Total,128,2,130,124,4,128,3,0,3,0,0,0,255,6,261
3690,Pondicherry,2011,Central Jail,97,3,100,97,2,99,0,0,0,0,0,0,194,5,199
3691,Pondicherry,2011,District Jail,0,0,0,0,0,0,0,0,0,0,0,0,0,0,0
3692,Pondicherry,2011,Sub_Jail,0,0,0,0,0,0,0,0,0,0,0,0,0,0,0
3693,Pondicherry,2011,Women Jail,0,0,0,0,0,0,0,0,0,0,0,0,0,0,0
3694,Pondicherry,2011,Borstal School,0,0,0,0,0,0,0,0,0,0,0,0,0,0,0
3695,Pondicherry,2011,Open Jail,0,0,0,0,0,0,0,0,0,0,0,0,0,0,0
3696,Pondicherry,2011,Special Jail,30,0,30,13,0,13,0,0,0,0,0,0,43,0,43
3697,Pondicherry,2011,Others,0,0,0,0,0,0,0,0,0,0,0,0,0,0,0
3698,Pondicherry,2011,Total,127,3,130,110,2,112,0,0,0,0,0,0,237,5,242
3699,Pondicherry,2012,Central Jail,83,2,85,117,1,118,0,0,0,0,0,0,200,3,203
3700,Pondicherry,2012,District Jail,0,0,0,0,0,0,0,0,0,0,0,0,0,0,0
3701,Pondicherry,2012,Sub_Jail,0,0,0,2,0,2,0,0,0,0,0,0,2,0,2
3702,Pondicherry,2012,Women Jail,0,0,0,0,0,0,0,0,0,0,0,0,0,0,0
3703,Pondicherry,2012,Borstal School,0,0,0,0,0,0,0,0,0,0,0,0,0,0,0
3704,Pondicherry,2012,Open Jail,0,0,0,0,0,0,0,0,0,0,0,0,0,0,0
3705,Pondicherry,2012,Special Jail,24,0,24,56,0,56,0,0,0,0,0,0,80,0,80
3706,Pondicherry,2012,Others,0,0,0,0,0,0,0,0,0,0,0,0,0,0,0
3707,Pondicherry,2012,Total,107,2,109,175,1,176,0,0,0,0,0,0,282,3,285
3708,Andhra Pradesh,2013,Central Jail,3527,117,3644,3448,77,3525,6,0,6,7,0,7,6988,194,7182
3709,Andhra Pradesh,2013,District Jail,419,1,420,2710,203,2913,0,0,0,0,0,0,3129,204,3333
3710,Andhra Pradesh,2013,Sub_Jail,79,0,79,2934,183,3117,0,0,0,0,0,0,3013,183,3196
3711,Andhra Pradesh,2013,Women Jail,0,171,171,0,146,146,0,1,1,0,0,0,0,318,318
3712,Andhra Pradesh,2013,Borstal School,3,0,3,0,0,0,0,0,0,0,0,0,3,0,3
3713,Andhra Pradesh,2013,Open Jail,281,0,281,0,0,0,0,0,0,0,0,0,281,0,281
3714,Andhra Pradesh,2013,Special Jail,0,0,0,0,0,0,0,0,0,0,0,0,0,0,0
3715,Andhra Pradesh,2013,Others,0,0,0,0,0,0,0,0,0,0,0,0,0,0,0
3716,Andhra Pradesh,2013,Total,4309,289,4598,9092,609,9701,6,1,7,7,0,7,13414,899,14313
3717,Arunachal Pradesh,2013,Central Jail,0,0,0,0,0,0,0,0,0,0,0,0,0,0,0
3718,Arunachal Pradesh,2013,District Jail,10,1,11,80,1,81,0,0,0,0,0,0,90,2,92
3719,Arunachal Pradesh,2013,Sub_Jail,0,0,0,0,0,0,0,0,0,0,0,0,0,0,0
3720,Arunachal Pradesh,2013,Women Jail,0,0,0,0,0,0,0,0,0,0,0,0,0,0,0
3721,Arunachal Pradesh,2013,Borstal School,0,0,0,0,0,0,0,0,0,0,0,0,0,0,0
3722,Arunachal Pradesh,2013,Open Jail,0,0,0,0,0,0,0,0,0,0,0,0,0,0,0
3723,Arunachal Pradesh,2013,Special Jail,0,0,0,0,0,0,0,0,0,0,0,0,0,0,0
3724,Arunachal Pradesh,2013,Others,0,0,0,0,0,0,0,0,0,0,0,0,0,0,0
3725,Arunachal Pradesh,2013,Total,10,1,11,80,1,81,0,0,0,0,0,0,90,2,92
3726,Assam,2013,Central Jail,1228,40,1268,1817,75,1892,1,0,1,1,0,1,3047,115,3162
3727,Assam,2013,District Jail,1661,59,1720,2836,118,2954,4,0,4,1,0,1,4502,177,4679
3728,Assam,2013,Sub_Jail,3,0,3,69,0,69,0,0,0,0,0,0,72,0,72
3729,Assam,2013,Women Jail,0,0,0,0,0,0,0,0,0,0,0,0,0,0,0
3730,Assam,2013,Borstal School,0,0,0,0,0,0,0,0,0,0,0,0,0,0,0
3731,Assam,2013,Open Jail,27,0,27,0,0,0,0,0,0,0,0,0,27,0,27
3732,Assam,2013,Special Jail,73,2,75,236,12,248,0,0,0,0,0,0,309,14,323
3733,Assam,2013,Others,0,0,0,0,0,0,0,0,0,0,0,0,0,0,0
3734,Assam,2013,Total,2992,101,3093,4958,205,5163,5,0,5,2,0,2,7957,306,8263
3735,Bihar,2013,Central Jail,2242,47,2289,7425,303,7728,5,0,5,1,0,1,9673,350,10023
3736,Bihar,2013,District Jail,1342,32,1374,14626,519,15145,21,0,21,127,4,131,16116,555,16671
3737,Bihar,2013,Sub_Jail,148,4,152,3153,115,3268,0,0,0,12,0,12,3313,119,3432
3738,Bihar,2013,Women Jail,0,40,40,0,36,36,0,0,0,0,0,0,0,76,76
3739,Bihar,2013,Borstal School,0,0,0,0,0,0,0,0,0,0,0,0,0,0,0
3740,Bihar,2013,Open Jail,92,0,92,0,0,0,0,0,0,0,0,0,92,0,92
3741,Bihar,2013,Special Jail,533,0,533,432,0,432,0,0,0,0,0,0,965,0,965
3742,Bihar,2013,Others,0,0,0,0,0,0,0,0,0,0,0,0,0,0,0
3743,Bihar,2013,Total,4357,123,4480,25636,973,26609,26,0,26,140,4,144,30159,1100,31259
3744,Chhatisgarh,2013,Central Jail,6069,303,6372,3895,405,4300,1,0,1,4,0,4,9969,708,10677
3745,Chhatisgarh,2013,District Jail,169,2,171,3072,111,3183,0,0,0,4,0,4,3245,113,3358
3746,Chhatisgarh,2013,Sub_Jail,43,0,43,1758,0,1758,0,0,0,4,0,4,1805,0,1805
3747,Chhatisgarh,2013,Women Jail,0,0,0,0,0,0,0,0,0,0,0,0,0,0,0
3748,Chhatisgarh,2013,Borstal School,0,0,0,0,0,0,0,0,0,0,0,0,0,0,0
3749,Chhatisgarh,2013,Open Jail,0,0,0,0,0,0,0,0,0,0,0,0,0,0,0
3750,Chhatisgarh,2013,Special Jail,0,0,0,0,0,0,0,0,0,0,0,0,0,0,0
3751,Chhatisgarh,2013,Others,0,0,0,0,0,0,0,0,0,0,0,0,0,0,0
3752,Chhatisgarh,2013,Total,6281,305,6586,8725,516,9241,1,0,1,12,0,12,15019,821,15840
3753,Goa,2013,Central Jail,100,0,100,3,0,3,0,0,0,0,0,0,103,0,103
3754,Goa,2013,District Jail,0,0,0,0,0,0,0,0,0,0,0,0,0,0,0
3755,Goa,2013,Sub_Jail,20,7,27,270,21,291,0,0,0,0,0,0,290,28,318
3756,Goa,2013,Women Jail,0,0,0,0,0,0,0,0,0,0,0,0,0,0,0
3757,Goa,2013,Borstal School,0,0,0,0,0,0,0,0,0,0,0,0,0,0,0
3758,Goa,2013,Open Jail,0,0,0,0,0,0,0,0,0,0,0,0,0,0,0
3759,Goa,2013,Special Jail,0,0,0,0,0,0,0,0,0,0,0,0,0,0,0
3760,Goa,2013,Others,0,0,0,102,0,102,0,0,0,0,0,0,102,0,102
3761,Goa,2013,Total,120,7,127,375,21,396,0,0,0,0,0,0,495,28,523
3762,Gujarat,2013,Central Jail,3127,113,3240,3601,130,3731,357,12,369,0,0,0,7085,255,7340
3763,Gujarat,2013,District Jail,244,2,246,1834,74,1908,152,4,156,0,0,0,2230,80,2310
3764,Gujarat,2013,Sub_Jail,152,1,153,1436,86,1522,21,0,21,0,0,0,1609,87,1696
3765,Gujarat,2013,Women Jail,0,50,50,0,65,65,0,16,16,0,0,0,0,131,131
3766,Gujarat,2013,Borstal School,0,0,0,0,0,0,0,0,0,0,0,0,0,0,0
3767,Gujarat,2013,Open Jail,56,0,56,0,0,0,0,0,0,0,0,0,56,0,56
3768,Gujarat,2013,Special Jail,63,0,63,354,24,378,84,0,84,0,0,0,501,24,525
3769,Gujarat,2013,Others,0,0,0,0,0,0,0,0,0,0,0,0,0,0,0
3770,Gujarat,2013,Total,3642,166,3808,7225,379,7604,614,32,646,0,0,0,11481,577,12058
3771,Haryana,2013,Central Jail,1230,28,1258,1668,40,1708,0,0,0,0,0,0,2898,68,2966
3772,Haryana,2013,District Jail,5358,292,5650,8369,385,8754,0,0,0,1,0,1,13728,677,14405
3773,Haryana,2013,Sub_Jail,0,0,0,0,0,0,0,0,0,0,0,0,0,0,0
3774,Haryana,2013,Women Jail,0,0,0,0,0,0,0,0,0,0,0,0,0,0,0
3775,Haryana,2013,Borstal School,77,35,112,111,50,161,0,0,0,0,0,0,188,85,273
3776,Haryana,2013,Open Jail,0,0,0,0,0,0,0,0,0,0,0,0,0,0,0
3777,Haryana,2013,Special Jail,0,0,0,0,0,0,0,0,0,0,0,0,0,0,0
3778,Haryana,2013,Others,0,0,0,0,0,0,0,0,0,0,0,0,0,0,0
3779,Haryana,2013,Total,6665,355,7020,10148,475,10623,0,0,0,1,0,1,16814,830,17644
3780,Himachal Pradesh,2013,Central Jail,634,21,655,249,15,264,0,0,0,0,0,0,883,36,919
3781,Himachal Pradesh,2013,District Jail,190,5,195,192,18,210,0,0,0,0,0,0,382,23,405
3782,Himachal Pradesh,2013,Sub_Jail,80,12,92,499,25,524,0,0,0,0,0,0,579,37,616
3783,Himachal Pradesh,2013,Women Jail,0,0,0,0,0,0,0,0,0,0,0,0,0,0,0
3784,Himachal Pradesh,2013,Borstal School,7,0,7,0,0,0,0,0,0,0,0,0,7,0,7
3785,Himachal Pradesh,2013,Open Jail,52,0,52,0,0,0,0,0,0,0,0,0,52,0,52
3786,Himachal Pradesh,2013,Special Jail,0,0,0,0,0,0,0,0,0,0,0,0,0,0,0
3787,Himachal Pradesh,2013,Others,0,0,0,0,0,0,0,0,0,0,0,0,0,0,0
3788,Himachal Pradesh,2013,Total,963,38,1001,940,58,998,0,0,0,0,0,0,1903,96,1999
3789,Jammu & Kashmir,2013,Central Jail,243,4,247,533,22,555,32,1,33,0,0,0,808,27,835
3790,Jammu & Kashmir,2013,District Jail,126,6,132,1186,54,1240,34,0,34,0,0,0,1346,60,1406
3791,Jammu & Kashmir,2013,Sub_Jail,1,0,1,105,0,105,5,0,5,0,0,0,111,0,111
3792,Jammu & Kashmir,2013,Women Jail,0,0,0,0,0,0,0,0,0,0,0,0,0,0,0
3793,Jammu & Kashmir,2013,Borstal School,0,0,0,0,0,0,0,0,0,0,0,0,0,0,0
3794,Jammu & Kashmir,2013,Open Jail,0,0,0,0,0,0,0,0,0,0,0,0,0,0,0
3795,Jammu & Kashmir,2013,Special Jail,0,0,0,0,0,0,0,0,0,0,0,0,0,0,0
3796,Jammu & Kashmir,2013,Others,0,0,0,0,0,0,0,0,0,0,0,0,0,0,0
3797,Jammu & Kashmir,2013,Total,370,10,380,1824,76,1900,71,1,72,0,0,0,2265,87,2352
3798,Jharkhand,2013,Central Jail,3782,152,3934,4336,217,4553,9,0,9,0,0,0,8127,369,8496
3799,Jharkhand,2013,District Jail,185,5,190,7743,409,8152,1,0,1,0,0,0,7929,414,8343
3800,Jharkhand,2013,Sub_Jail,31,1,32,1199,66,1265,0,0,0,0,0,0,1230,67,1297
3801,Jharkhand,2013,Women Jail,0,0,0,0,0,0,0,0,0,0,0,0,0,0,0
3802,Jharkhand,2013,Borstal School,0,0,0,61,0,61,0,0,0,0,0,0,61,0,61
3803,Jharkhand,2013,Open Jail,6,0,6,17,0,17,0,0,0,0,0,0,23,0,23
3804,Jharkhand,2013,Special Jail,0,0,0,0,0,0,0,0,0,0,0,0,0,0,0
3805,Jharkhand,2013,Others,0,0,0,0,0,0,0,0,0,0,0,0,0,0,0
3806,Jharkhand,2013,Total,4004,158,4162,13356,692,14048,10,0,10,0,0,0,17370,850,18220
3807,Karnataka,2013,Central Jail,4052,196,4248,4847,235,5082,133,8,141,4,0,4,9036,439,9475
3808,Karnataka,2013,District Jail,114,2,116,2090,69,2159,30,1,31,0,0,0,2234,72,2306
3809,Karnataka,2013,Sub_Jail,39,0,39,2002,70,2072,12,3,15,2,0,2,2055,73,2128
3810,Karnataka,2013,Women Jail,0,0,0,0,0,0,0,0,0,0,0,0,0,0,0
3811,Karnataka,2013,Borstal School,0,0,0,0,0,0,0,0,0,0,0,0,0,0,0
3812,Karnataka,2013,Open Jail,12,0,12,0,0,0,0,0,0,0,0,0,12,0,12
3813,Karnataka,2013,Special Jail,3,0,3,193,0,193,0,0,0,1,0,1,197,0,197
3814,Karnataka,2013,Others,0,0,0,0,0,0,0,0,0,0,0,0,0,0,0
3815,Karnataka,2013,Total,4220,198,4418,9132,374,9506,175,12,187,7,0,7,13534,584,14118
3816,Kerala,2013,Central Jail,1825,0,1825,1016,0,1016,0,0,0,0,0,0,2841,0,2841
3817,Kerala,2013,District Jail,235,0,235,1505,22,1527,0,0,0,0,0,0,1740,22,1762
3818,Kerala,2013,Sub_Jail,71,0,71,761,0,761,0,0,0,0,0,0,832,0,832
3819,Kerala,2013,Women Jail,0,47,47,0,88,88,0,0,0,0,2,2,0,137,137
3820,Kerala,2013,Borstal School,4,0,4,15,9,24,0,0,0,0,0,0,19,9,28
3821,Kerala,2013,Open Jail,390,0,390,0,0,0,0,0,0,0,0,0,390,0,390
3822,Kerala,2013,Special Jail,51,1,52,1184,21,1205,0,0,0,0,0,0,1235,22,1257
3823,Kerala,2013,Others,148,0,148,0,0,0,0,0,0,0,0,0,148,0,148
3824,Kerala,2013,Total,2724,48,2772,4481,140,4621,0,0,0,0,2,2,7205,190,7395
3825,Madhya Pradesh,2013,Central Jail,12431,356,12787,5385,268,5653,117,0,117,34,0,34,17967,624,18591
3826,Madhya Pradesh,2013,District Jail,2593,151,2744,5501,264,5765,3,0,3,83,3,86,8180,418,8598
3827,Madhya Pradesh,2013,Sub_Jail,1304,9,1313,6115,35,6150,4,0,4,27,0,27,7450,44,7494
3828,Madhya Pradesh,2013,Women Jail,0,0,0,0,0,0,0,0,0,0,0,0,0,0,0
3829,Madhya Pradesh,2013,Borstal School,0,0,0,0,0,0,0,0,0,0,0,0,0,0,0
3830,Madhya Pradesh,2013,Open Jail,25,0,25,0,0,0,0,0,0,0,0,0,25,0,25
3831,Madhya Pradesh,2013,Special Jail,0,0,0,0,0,0,0,0,0,0,0,0,0,0,0
3832,Madhya Pradesh,2013,Others,0,0,0,0,0,0,0,0,0,0,0,0,0,0,0
3833,Madhya Pradesh,2013,Total,16353,516,16869,17001,567,17568,124,0,124,144,3,147,33622,1086,34708
3834,Maharashtra,2013,Central Jail,6280,397,6677,11570,256,11826,24,0,24,0,0,0,17874,653,18527
3835,Maharashtra,2013,District Jail,338,4,342,6506,501,7007,3,0,3,0,0,0,6847,505,7352
3836,Maharashtra,2013,Sub_Jail,1,0,1,69,3,72,0,0,0,0,0,0,70,3,73
3837,Maharashtra,2013,Women Jail,0,4,4,0,361,361,0,1,1,0,0,0,0,366,366
3838,Maharashtra,2013,Borstal School,29,0,29,0,0,0,0,0,0,0,0,0,29,0,29
3839,Maharashtra,2013,Open Jail,943,32,975,0,0,0,0,0,0,0,0,0,943,32,975
3840,Maharashtra,2013,Special Jail,3,0,3,65,0,65,0,0,0,0,0,0,68,0,68
3841,Maharashtra,2013,Others,10,0,10,0,0,0,0,0,0,0,0,0,10,0,10
3842,Maharashtra,2013,Total,7604,437,8041,18210,1121,19331,27,1,28,0,0,0,25841,1559,27400
3843,Manipur,2013,Central Jail,77,2,79,508,30,538,40,3,43,0,0,0,625,35,660
3844,Manipur,2013,District Jail,0,0,0,0,0,0,0,0,0,0,0,0,0,0,0
3845,Manipur,2013,Sub_Jail,0,0,0,0,0,0,0,0,0,0,0,0,0,0,0
3846,Manipur,2013,Women Jail,0,0,0,0,0,0,0,0,0,0,0,0,0,0,0
3847,Manipur,2013,Borstal School,0,0,0,0,0,0,0,0,0,0,0,0,0,0,0
3848,Manipur,2013,Open Jail,0,0,0,0,0,0,0,0,0,0,0,0,0,0,0
3849,Manipur,2013,Special Jail,0,0,0,0,0,0,0,0,0,0,0,0,0,0,0
3850,Manipur,2013,Others,0,0,0,0,0,0,0,0,0,0,0,0,0,0,0
3851,Manipur,2013,Total,77,2,79,508,30,538,40,3,43,0,0,0,625,35,660
3852,Meghalaya,2013,Central Jail,0,0,0,0,0,0,0,0,0,0,0,0,0,0,0
3853,Meghalaya,2013,District Jail,72,0,72,734,11,745,33,0,33,0,0,0,839,11,850
3854,Meghalaya,2013,Sub_Jail,0,0,0,0,0,0,0,0,0,0,0,0,0,0,0
3855,Meghalaya,2013,Women Jail,0,0,0,0,0,0,0,0,0,0,0,0,0,0,0
3856,Meghalaya,2013,Borstal School,0,0,0,0,0,0,0,0,0,0,0,0,0,0,0
3857,Meghalaya,2013,Open Jail,0,0,0,0,0,0,0,0,0,0,0,0,0,0,0
3858,Meghalaya,2013,Special Jail,0,0,0,0,0,0,0,0,0,0,0,0,0,0,0
3859,Meghalaya,2013,Others,0,0,0,0,0,0,0,0,0,0,0,0,0,0,0
3860,Meghalaya,2013,Total,72,0,72,734,11,745,33,0,33,0,0,0,839,11,850
3861,Mizoram,2013,Central Jail,221,3,224,153,20,173,0,0,0,0,0,0,374,23,397
3862,Mizoram,2013,District Jail,181,5,186,249,38,287,0,0,0,0,0,0,430,43,473
3863,Mizoram,2013,Sub_Jail,0,0,0,0,0,0,0,0,0,0,0,0,0,0,0
3864,Mizoram,2013,Women Jail,0,0,0,0,0,0,0,0,0,0,0,0,0,0,0
3865,Mizoram,2013,Borstal School,0,0,0,0,0,0,0,0,0,0,0,0,0,0,0
3866,Mizoram,2013,Open Jail,0,0,0,0,0,0,0,0,0,0,0,0,0,0,0
3867,Mizoram,2013,Special Jail,0,0,0,0,0,0,0,0,0,0,0,0,0,0,0
3868,Mizoram,2013,Others,0,0,0,0,0,0,0,0,0,0,0,0,0,0,0
3869,Mizoram,2013,Total,402,8,410,402,58,460,0,0,0,0,0,0,804,66,870
3870,Nagaland,2013,Central Jail,57,0,57,104,0,104,46,0,46,1,0,1,208,0,208
3871,Nagaland,2013,District Jail,7,0,7,97,2,99,1,0,1,0,0,0,105,2,107
3872,Nagaland,2013,Sub_Jail,27,4,31,132,6,138,3,0,3,0,0,0,162,10,172
3873,Nagaland,2013,Women Jail,0,0,0,0,0,0,0,0,0,0,0,0,0,0,0
3874,Nagaland,2013,Borstal School,0,0,0,0,0,0,0,0,0,0,0,0,0,0,0
3875,Nagaland,2013,Open Jail,0,0,0,0,0,0,0,0,0,0,0,0,0,0,0
3876,Nagaland,2013,Special Jail,0,0,0,0,0,0,0,0,0,0,0,0,0,0,0
3877,Nagaland,2013,Others,0,0,0,0,0,0,0,0,0,0,0,0,0,0,0
3878,Nagaland,2013,Total,91,4,95,333,8,341,50,0,50,1,0,1,475,12,487
3879,Orissa,2013,Central Jail,1085,44,1129,1970,78,2048,0,0,0,0,0,0,3055,122,3177
3880,Orissa,2013,District Jail,957,28,985,2026,98,2124,0,0,0,0,0,0,2983,126,3109
3881,Orissa,2013,Sub_Jail,1040,30,1070,5519,285,5804,0,0,0,0,0,0,6559,315,6874
3882,Orissa,2013,Women Jail,0,11,11,0,16,16,0,0,0,0,0,0,0,27,27
3883,Orissa,2013,Borstal School,0,0,0,0,0,0,0,0,0,0,0,0,0,0,0
3884,Orissa,2013,Open Jail,95,0,95,0,0,0,0,0,0,0,0,0,95,0,95
3885,Orissa,2013,Special Jail,209,9,218,931,42,973,0,0,0,0,0,0,1140,51,1191
3886,Orissa,2013,Others,0,0,0,0,0,0,0,0,0,0,0,0,0,0,0
3887,Orissa,2013,Total,3386,122,3508,10446,519,10965,0,0,0,0,0,0,13832,641,14473
3888,Punjab,2013,Central Jail,6053,276,6329,13388,573,13961,1,0,1,1,0,1,19443,849,20292
3889,Punjab,2013,District Jail,1861,133,1994,2764,227,2991,3,0,3,2,0,2,4630,360,4990
3890,Punjab,2013,Sub_Jail,358,0,358,1178,0,1178,0,0,0,0,0,0,1536,0,1536
3891,Punjab,2013,Women Jail,0,79,79,0,176,176,0,0,0,0,0,0,0,255,255
3892,Punjab,2013,Borstal School,114,0,114,200,0,200,0,0,0,0,0,0,314,0,314
3893,Punjab,2013,Open Jail,62,0,62,0,0,0,0,0,0,0,0,0,62,0,62
3894,Punjab,2013,Special Jail,0,0,0,0,0,0,0,0,0,0,0,0,0,0,0
3895,Punjab,2013,Others,0,0,0,0,0,0,0,0,0,0,0,0,0,0,0
3896,Punjab,2013,Total,8448,488,8936,17530,976,18506,4,0,4,3,0,3,25985,1464,27449
3897,Rajasthan,2013,Central Jail,4387,0,4387,4839,137,4976,0,0,0,2,0,2,9228,137,9365
3898,Rajasthan,2013,District Jail,801,0,801,4817,150,4967,0,0,0,0,0,0,5618,150,5768
3899,Rajasthan,2013,Sub_Jail,1,0,1,3147,21,3168,0,0,0,1,0,1,3149,21,3170
3900,Rajasthan,2013,Women Jail,0,189,189,0,135,135,0,0,0,0,0,0,0,324,324
3901,Rajasthan,2013,Borstal School,8,0,8,0,0,0,0,0,0,0,0,0,8,0,8
3902,Rajasthan,2013,Open Jail,628,30,658,0,0,0,0,0,0,0,0,0,628,30,658
3903,Rajasthan,2013,Special Jail,0,0,0,0,0,0,0,0,0,0,0,0,0,0,0
3904,Rajasthan,2013,Others,0,0,0,0,0,0,0,0,0,0,0,0,0,0,0
3905,Rajasthan,2013,Total,5825,219,6044,12803,443,13246,0,0,0,3,0,3,18631,662,19293
3906,Sikkim,2013,Central Jail,102,2,104,74,3,77,0,0,0,0,0,0,176,5,181
3907,Sikkim,2013,District Jail,0,0,0,46,3,49,0,0,0,0,0,0,46,3,49
3908,Sikkim,2013,Sub_Jail,0,0,0,0,0,0,0,0,0,0,0,0,0,0,0
3909,Sikkim,2013,Women Jail,0,0,0,0,0,0,0,0,0,0,0,0,0,0,0
3910,Sikkim,2013,Borstal School,0,0,0,0,0,0,0,0,0,0,0,0,0,0,0
3911,Sikkim,2013,Open Jail,0,0,0,0,0,0,0,0,0,0,0,0,0,0,0
3912,Sikkim,2013,Special Jail,0,0,0,0,0,0,0,0,0,0,0,0,0,0,0
3913,Sikkim,2013,Others,0,0,0,0,0,0,0,0,0,0,0,0,0,0,0
3914,Sikkim,2013,Total,102,2,104,120,6,126,0,0,0,0,0,0,222,8,230
3915,Tamilnadu,2013,Central Jail,4438,0,4438,4994,37,5031,1727,0,1727,0,0,0,11159,37,11196
3916,Tamilnadu,2013,District Jail,0,0,0,699,0,699,0,0,0,0,0,0,699,0,699
3917,Tamilnadu,2013,Sub_Jail,0,0,0,1618,114,1732,0,0,0,0,0,0,1618,114,1732
3918,Tamilnadu,2013,Women Jail,0,162,162,0,278,278,0,48,48,0,0,0,0,488,488
3919,Tamilnadu,2013,Borstal School,11,0,11,484,0,484,6,0,6,0,0,0,501,0,501
3920,Tamilnadu,2013,Open Jail,37,0,37,0,0,0,0,0,0,0,0,0,37,0,37
3921,Tamilnadu,2013,Special Jail,0,0,0,0,68,68,0,0,0,0,0,0,0,68,68
3922,Tamilnadu,2013,Others,0,0,0,0,0,0,0,0,0,0,0,0,0,0,0
3923,Tamilnadu,2013,Total,4486,162,4648,7795,497,8292,1733,48,1781,0,0,0,14014,707,14721
3924,Tripura,2013,Central Jail,280,14,294,111,5,116,0,0,0,0,0,0,391,19,410
3925,Tripura,2013,District Jail,101,0,101,64,0,64,0,0,0,0,0,0,165,0,165
3926,Tripura,2013,Sub_Jail,107,0,107,213,6,219,0,0,0,0,0,0,320,6,326
3927,Tripura,2013,Women Jail,0,0,0,0,0,0,0,0,0,0,0,0,0,0,0
3928,Tripura,2013,Borstal School,0,0,0,0,0,0,0,0,0,0,0,0,0,0,0
3929,Tripura,2013,Open Jail,0,0,0,0,0,0,0,0,0,0,0,0,0,0,0
3930,Tripura,2013,Special Jail,0,0,0,0,0,0,0,0,0,0,0,0,0,0,0
3931,Tripura,2013,Others,0,0,0,0,0,0,0,0,0,0,0,0,0,0,0
3932,Tripura,2013,Total,488,14,502,388,11,399,0,0,0,0,0,0,876,25,901
3933,Uttar Pradesh,2013,Central Jail,8283,31,8314,4092,78,4170,0,0,0,0,0,0,12375,109,12484
3934,Uttar Pradesh,2013,District Jail,15537,625,16162,50924,2244,53168,90,0,90,18,0,18,66569,2869,69438
3935,Uttar Pradesh,2013,Sub_Jail,109,4,113,730,27,757,0,0,0,0,0,0,839,31,870
3936,Uttar Pradesh,2013,Women Jail,0,303,303,0,0,0,0,0,0,0,0,0,0,303,303
3937,Uttar Pradesh,2013,Borstal School,0,0,0,0,0,0,0,0,0,0,0,0,0,0,0
3938,Uttar Pradesh,2013,Open Jail,0,0,0,0,0,0,0,0,0,0,0,0,0,0,0
3939,Uttar Pradesh,2013,Special Jail,418,0,418,5,0,5,0,0,0,0,0,0,423,0,423
3940,Uttar Pradesh,2013,Others,0,0,0,0,0,0,0,0,0,0,0,0,0,0,0
3941,Uttar Pradesh,2013,Total,24347,963,25310,55751,2349,58100,90,0,90,18,0,18,80206,3312,83518
3942,Uttaranchal,2013,Central Jail,28,0,28,0,0,0,0,0,0,0,0,0,28,0,28
3943,Uttaranchal,2013,District Jail,1601,84,1685,1080,73,1153,0,0,0,0,0,0,2681,157,2838
3944,Uttaranchal,2013,Sub_Jail,56,1,57,747,24,771,0,0,0,0,0,0,803,25,828
3945,Uttaranchal,2013,Women Jail,0,0,0,0,0,0,0,0,0,0,0,0,0,0,0
3946,Uttaranchal,2013,Borstal School,0,0,0,0,0,0,0,0,0,0,0,0,0,0,0
3947,Uttaranchal,2013,Open Jail,151,0,151,0,0,0,0,0,0,0,0,0,151,0,151
3948,Uttaranchal,2013,Special Jail,0,0,0,0,0,0,0,0,0,0,0,0,0,0,0
3949,Uttaranchal,2013,Others,0,0,0,0,0,0,0,0,0,0,0,0,0,0,0
3950,Uttaranchal,2013,Total,1836,85,1921,1827,97,1924,0,0,0,0,0,0,3663,182,3845
3951,West Bengal,2013,Central Jail,4590,174,4764,6650,261,6911,0,0,0,364,46,410,11604,481,12085
3952,West Bengal,2013,District Jail,676,31,707,3714,259,3973,0,0,0,3,1,4,4393,291,4684
3953,West Bengal,2013,Sub_Jail,99,7,106,4293,194,4487,0,0,0,2,1,3,4394,202,4596
3954,West Bengal,2013,Women Jail,0,150,150,0,206,206,0,0,0,0,0,0,0,356,356
3955,West Bengal,2013,Borstal School,0,0,0,0,0,0,0,0,0,0,0,0,0,0,0
3956,West Bengal,2013,Open Jail,91,0,91,0,0,0,0,0,0,0,0,0,91,0,91
3957,West Bengal,2013,Special Jail,67,5,72,836,58,894,0,0,0,0,0,0,903,63,966
3958,West Bengal,2013,Others,0,0,0,0,0,0,0,0,0,0,0,0,0,0,0
3959,West Bengal,2013,Total,5523,367,5890,15493,978,16471,0,0,0,369,48,417,21385,1393,22778
3960,A & N Islands,2013,Central Jail,0,0,0,0,0,0,0,0,0,0,0,0,0,0,0
3961,A & N Islands,2013,District Jail,709,1,710,172,7,179,0,0,0,0,0,0,881,8,889
3962,A & N Islands,2013,Sub_Jail,2,0,2,14,0,14,0,0,0,0,0,0,16,0,16
3963,A & N Islands,2013,Women Jail,0,0,0,0,0,0,0,0,0,0,0,0,0,0,0
3964,A & N Islands,2013,Borstal School,0,0,0,0,0,0,0,0,0,0,0,0,0,0,0
3965,A & N Islands,2013,Open Jail,0,0,0,0,0,0,0,0,0,0,0,0,0,0,0
3966,A & N Islands,2013,Special Jail,244,0,244,0,0,0,0,0,0,0,0,0,244,0,244
3967,A & N Islands,2013,Others,0,0,0,0,0,0,0,0,0,0,0,0,0,0,0
3968,A & N Islands,2013,Total,955,1,956,186,7,193,0,0,0,0,0,0,1141,8,1149
3969,Chandigarh,2013,Central Jail,258,12,270,379,12,391,0,0,0,0,0,0,637,24,661
3970,Chandigarh,2013,District Jail,0,0,0,0,0,0,0,0,0,0,0,0,0,0,0
3971,Chandigarh,2013,Sub_Jail,0,0,0,0,0,0,0,0,0,0,0,0,0,0,0
3972,Chandigarh,2013,Women Jail,0,0,0,0,0,0,0,0,0,0,0,0,0,0,0
3973,Chandigarh,2013,Borstal School,0,0,0,0,0,0,0,0,0,0,0,0,0,0,0
3974,Chandigarh,2013,Open Jail,0,0,0,0,0,0,0,0,0,0,0,0,0,0,0
3975,Chandigarh,2013,Special Jail,0,0,0,0,0,0,0,0,0,0,0,0,0,0,0
3976,Chandigarh,2013,Others,0,0,0,0,0,0,0,0,0,0,0,0,0,0,0
3977,Chandigarh,2013,Total,258,12,270,379,12,391,0,0,0,0,0,0,637,24,661
3978,D & N Haveli,2013,Central Jail,0,0,0,0,0,0,0,0,0,0,0,0,0,0,0
3979,D & N Haveli,2013,District Jail,0,0,0,0,0,0,0,0,0,0,0,0,0,0,0
3980,D & N Haveli,2013,Sub_Jail,0,0,0,35,0,35,0,0,0,0,0,0,35,0,35
3981,D & N Haveli,2013,Women Jail,0,0,0,0,0,0,0,0,0,0,0,0,0,0,0
3982,D & N Haveli,2013,Borstal School,0,0,0,0,0,0,0,0,0,0,0,0,0,0,0
3983,D & N Haveli,2013,Open Jail,0,0,0,0,0,0,0,0,0,0,0,0,0,0,0
3984,D & N Haveli,2013,Special Jail,0,0,0,0,0,0,0,0,0,0,0,0,0,0,0
3985,D & N Haveli,2013,Others,0,0,0,0,0,0,0,0,0,0,0,0,0,0,0
3986,D & N Haveli,2013,Total,0,0,0,35,0,35,0,0,0,0,0,0,35,0,35
3987,Daman & Diu,2013,Central Jail,0,0,0,0,0,0,0,0,0,0,0,0,0,0,0
3988,Daman & Diu,2013,District Jail,0,0,0,0,0,0,0,0,0,0,0,0,0,0,0
3989,Daman & Diu,2013,Sub_Jail,17,1,18,38,0,38,0,0,0,0,0,0,55,1,56
3990,Daman & Diu,2013,Women Jail,0,0,0,0,0,0,0,0,0,0,0,0,0,0,0
3991,Daman & Diu,2013,Borstal School,0,0,0,0,0,0,0,0,0,0,0,0,0,0,0
3992,Daman & Diu,2013,Open Jail,0,0,0,0,0,0,0,0,0,0,0,0,0,0,0
3993,Daman & Diu,2013,Special Jail,0,0,0,0,0,0,0,0,0,0,0,0,0,0,0
3994,Daman & Diu,2013,Others,0,0,0,0,0,0,0,0,0,0,0,0,0,0,0
3995,Daman & Diu,2013,Total,17,1,18,38,0,38,0,0,0,0,0,0,55,1,56
3996,Delhi,2013,Central Jail,2962,0,2962,8065,0,8065,6,0,6,4,0,4,11037,0,11037
3997,Delhi,2013,District Jail,285,0,285,1615,0,1615,0,0,0,0,0,0,1900,0,1900
3998,Delhi,2013,Sub_Jail,0,0,0,0,0,0,0,0,0,0,0,0,0,0,0
3999,Delhi,2013,Women Jail,0,141,141,0,474,474,0,0,0,0,0,0,0,615,615
4000,Delhi,2013,Borstal School,0,0,0,0,0,0,0,0,0,0,0,0,0,0,0
4001,Delhi,2013,Open Jail,0,0,0,0,0,0,0,0,0,0,0,0,0,0,0
4002,Delhi,2013,Special Jail,0,0,0,0,0,0,0,0,0,0,0,0,0,0,0
4003,Delhi,2013,Others,0,0,0,0,0,0,0,0,0,0,0,0,0,0,0
4004,Delhi,2013,Total,3247,141,3388,9680,474,10154,6,0,6,4,0,4,12937,615,13552
4005,Lakshadweep,2013,Central Jail,0,0,0,0,0,0,0,0,0,0,0,0,0,0,0
4006,Lakshadweep,2013,District Jail,0,0,0,0,0,0,0,0,0,0,0,0,0,0,0
4007,Lakshadweep,2013,Sub_Jail,0,0,0,0,0,0,0,0,0,0,0,0,0,0,0
4008,Lakshadweep,2013,Women Jail,0,0,0,0,0,0,0,0,0,0,0,0,0,0,0
4009,Lakshadweep,2013,Borstal School,0,0,0,0,0,0,0,0,0,0,0,0,0,0,0
4010,Lakshadweep,2013,Open Jail,0,0,0,0,0,0,0,0,0,0,0,0,0,0,0
4011,Lakshadweep,2013,Special Jail,0,0,0,0,0,0,0,0,0,0,0,0,0,0,0
4012,Lakshadweep,2013,Others,0,0,0,0,0,0,0,0,0,0,0,0,0,0,0
4013,Lakshadweep,2013,Total,0,0,0,0,0,0,0,0,0,0,0,0,0,0,0
4014,Pondicherry,2013,Central Jail,66,2,68,134,5,139,0,0,0,0,0,0,200,7,207
4015,Pondicherry,2013,District Jail,0,0,0,0,0,0,0,0,0,0,0,0,0,0,0
4016,Pondicherry,2013,Sub_Jail,0,0,0,0,0,0,0,0,0,0,0,0,0,0,0
4017,Pondicherry,2013,Women Jail,0,0,0,0,0,0,0,0,0,0,0,0,0,0,0
4018,Pondicherry,2013,Borstal School,0,0,0,0,0,0,0,0,0,0,0,0,0,0,0
4019,Pondicherry,2013,Open Jail,0,0,0,0,0,0,0,0,0,0,0,0,0,0,0
4020,Pondicherry,2013,Special Jail,23,0,23,50,0,50,0,0,0,0,0,0,73,0,73
4021,Pondicherry,2013,Others,0,0,0,0,0,0,0,0,0,0,0,0,0,0,0
4022,Pondicherry,2013,Total,89,2,91,184,5,189,0,0,0,0,0,0,273,7,280
